塩	しお	Noun:|1. salt (e.g. sodium chloride, calcium sulfate, etc.) (Chemistry term) (esp. えん)
会合	かいごう	Noun, Suru verb:|1. association (Chemistry term)
分解	ぶんかい	Noun, Suru verb, No-adjective:|1. decomposition; resolution (Chemistry term)
酸性	さんせい	Noun:|1. acidity (Chemistry term)|No-adjective:|2. acidic (Chemistry term)
結合	けつごう	Noun, Suru verb:|1. bond (Chemistry term)
酸化	さんか	Noun, Suru verb:|1. oxidation; oxidization (Chemistry term)
異性	いせい	Noun, No-adjective:|1. isomerism (Chemistry term)
還元	かんげん	Noun, Suru verb:|1. reduction; resolution; deoxidization; deoxidation (Chemistry term)
化合物	かごうぶつ	Noun:|1. compound (Chemistry term)
昇華	しょうか	Noun, Suru verb:|1. sublimation (Chemistry term)
濃度	のうど	Noun:|1. concentration; thickness; density (Chemistry term)
分散	ぶんさん	Noun, Suru verb:|1. dispersion (Chemistry term, Physics terminology)
レトルト	Noun:|1. retort; glass vessel used for distillation (now largely obs.) (Chemistry term)
塩基性	えんきせい	Noun:|1. basicity; alkalinity (Chemistry term)|No-adjective:|2. basic; alkaline (Chemistry term)
時効	じこう	Noun:|1. ageing; aging (Chemistry term)
塩基	えんき	Noun:|1. base (Chemistry term)
変態	へんたい	Noun, Suru verb, No-adjective:|1. transformation; transition; modification (Chemistry term, Physics terminology)
モル	Noun, No-adjective:|1. mole; mol; gram molecule (Chemistry term, Physics terminology)
透析	とうせき	Noun, Suru verb, No-adjective:|1. dialysis (Chemistry term)
遊離	ゆうり	Noun, Suru verb:|1. extrication; release; isolation (Chemistry term)
遊離	ゆうり	Noun, Suru verb:|1. extrication; release; isolation (Chemistry term)
芳香族化合物	ほうこうぞくかごうぶつ	Noun:|1. aromatic compound (Chemistry term)
誘導体	ゆうどうたい	Noun:|1. derivative (Chemistry term)
還元糖	かんげんとう	Noun:|1. reducing sugar (Chemistry term)
脂肪族化合物	しぼうぞくかごうぶつ	Noun:|1. aliphatic compound (Chemistry term)
有機酸	ゆうきさん	Noun:|1. organic acid (Chemistry term)
風解	ふうかい	Noun, Suru verb:|1. efflorescence; loss of crystallization water to the air (Chemistry term)
非金属元素	ひきんぞくげんそ	Noun:|1. nonmetallic element (Chemistry term)
鎖式化合物	さしきかごうぶつ	Noun:|1. open-chain compound; acyclic compound (Chemistry term)
超原子価	ちょうげんしか	Noun:|1. hypervalent compound (Chemistry term)
錯体	さくたい	Noun:|1. complex (Chemistry term)
希土類元素	きどるいげんそ	Noun:|1. rare-earth element; rare-earth metal (Chemistry term)
超酸	ちょうさん	Noun:|1. superacid (Chemistry term)
半減期	はんげんき	Noun:|1. half life (Physics terminology, Chemistry term)
緩和時間	かんわじかん	Noun:|1. relaxation time (Physics terminology, Chemistry term)
原子価	げんしか	Noun:|1. valence; valency (Chemistry term)
単結合	たんけつごう	Noun:|1. single bond (Chemistry term)
三重結合	さんじゅうけつごう	Noun:|1. triple bond (Chemistry term)
複素環式化合物	ふくそかんしきかごうぶつ	Noun:|1. heterocyclic compound (Chemistry term)
分子軌道	ぶんしきどう	Noun:|1. molecular orbital; MO (Chemistry term)
超原子価	ちょうげんしか	Noun:|1. hypervalent compound (Chemistry term)
錯体	さくたい	Noun:|1. complex (Chemistry term)
みょうばん	Noun:|1. alum (Chemistry term, Usually written using kana alone)
収着	しゅうちゃく	Noun:|1. sorption (Physics terminology, Chemistry term)
浸出	しんしゅつ	Noun, Suru verb:|1. infiltration; permeation; exudation; percolation; effusion; extraction (Chemistry term)
親和力	しんわりょく	Noun:|1. affinity (Chemistry term)
ｐＨ	ペーハー	Noun:|1. pH (Chemistry term) (ペーハー is from German)
二重結合	にじゅうけつごう	Noun:|1. double bond (Chemistry term)
中間体	ちゅうかんたい	Na-adjective:|1. intermediate (Chemistry term)
懸濁	けんだく	No-adjective, Suru verb:|1. suspended; suspension (as characteristic of a liquid) (Chemistry term)
固相	こそう	Noun:|1. solid phase (Chemistry term)
重量法	じゅうりょうほう	Noun:|1. gravimetric method (Chemistry term)
乳化剤	にゅうかざい	Noun:|1. emulsifier (Chemistry term)
弱塩基	じゃくえんき	Noun:|1. weak base (Chemistry term)
気相	きそう	Noun:|1. gas phase; gaseous phase (Chemistry term)
液相	えきそう	Noun:|1. liquid phase (Chemistry term)
失活	しっかつ	Noun:|1. deactivation (Chemistry term)
官能基	かんのうき	Noun:|1. functional group (Chemistry term)
置換	ちかん	Noun, Suru verb:|1. substitution; displacement (Chemistry term)
芒硝	ぼうしょう	Noun:|1. sal mirabilis; mirabilite; sodium sulfate decahydrate; sodium sulphate decahydrate (Chemistry term)
自己反応性物質	じこはんのうせいぶっしつ	Noun:|1. self-reactive substance (Chemistry term)
誘導反応	ゆうどうはんのう	Noun:|1. induced reaction (Chemistry term)
気相	きそう	Noun:|1. gas phase; gaseous phase (Chemistry term)
官能基	かんのうき	Noun:|1. functional group (Chemistry term)
ＬＮＧ	エルエヌジー	Noun:|1. liquefied natural gas; LNG (Chemistry term)
褐変反応	かっぺんはんのう	Noun:|1. browning reaction (Chemistry term)
直鎖	ちょくさ	Noun or verb acting prenominally, No-adjective:|1. straight-chain; open-chain; acyclic; linear (Chemistry term)
三酸	さんさん	Prefix, No-adjective:|1. triacid (Chemistry term)
類似体	るいじたい	Noun:|1. analog; analogue (Chemistry term)
超塩基	ちょうえんき	Noun:|1. superbase (Chemistry term)
自己集合	じこしゅうごう	Noun:|1. self-assembly (Chemistry term)
強塩基	きょうえんき	Noun:|1. strong base (Chemistry term)
反応性	はんのうせい	Noun:|1. reactivity (Chemistry term)
合成戦略	ごうせいせんりゃく	Noun:|1. synthesis strategy (Chemistry term)
親鉄元素	しんてつげんそ	Noun:|1. siderophile element (Geology, etc. term, Chemistry term)
架橋化合物	かきょうかごうぶつ	Noun:|1. bridged compound (Chemistry term)
不活性	ふかっせい	No-adjective:|1. inert (Chemistry term)
分解蒸溜法	ぶんかいじょうりゅうほう	Noun:|1. cracking (Chemistry term)
結合角	けつごうかく	Noun:|1. bond angle (Chemistry term)
液相	えきそう	Noun:|1. liquid phase (Chemistry term)
気相	きそう	Noun:|1. gas phase; gaseous phase (Chemistry term)
自己反応性物質	じこはんのうせいぶっしつ	Noun:|1. self-reactive substance (Chemistry term)
限外濾過	げんがいろか	Noun:|1. ultrafiltration (Chemistry term)
機能性高分子	きのうせいこうぶんし	Noun:|1. functional polymer (Chemistry term)
誘導反応	ゆうどうはんのう	Noun:|1. induced reaction (Chemistry term)
官能基	かんのうき	Noun:|1. functional group (Chemistry term)
類縁体	るいえんたい	Noun:|1. analog; analogue (Chemistry term)
反応性	はんのうせい	Noun:|1. reactivity (Chemistry term)
親鉄元素	しんてつげんそ	Noun:|1. siderophile element (Geology, etc. term, Chemistry term)
架橋化合物	かきょうかごうぶつ	Noun:|1. bridged compound (Chemistry term)
抱水	ほうすい	No-adjective:|1. hydrate (Chemistry term)
合成戦略	ごうせいせんりゃく	Noun:|1. synthesis strategy (Chemistry term)
分画	ぶんかく	Noun, Suru verb:|1. fractionation; fraction (Chemistry term)
大環状	だいかんじょう	No-adjective:|1. macrocyclic; large ring (Chemistry term)
綿状沈殿	めんじょうちんでん	Noun:|1. flocculent precipitate (Chemistry term)
準安定	じゅんあんてい	Noun, Na-adjective:|1. metastability (Physics terminology, Chemistry term)
不活性	ふかっせい	No-adjective:|1. inert (Chemistry term)
分解蒸溜法	ぶんかいじょうりゅうほう	Noun:|1. cracking (Chemistry term)
遊離酸	ゆうりさん	Noun:|1. free acid (Chemistry term)
ＬＮＧ	エルエヌジー	Noun:|1. liquefied natural gas; LNG (Chemistry term)
綿状沈殿	めんじょうちんでん	Noun:|1. flocculent precipitate (Chemistry term)
ＬＮＧ	エルエヌジー	Noun:|1. liquefied natural gas; LNG (Chemistry term)
示性式	しせいしき	Noun:|1. rational formula (Chemistry term)
銀鏡反応	ぎんきょうはんのう	Noun:|1. silver mirror reaction (Chemistry term)
分解蒸溜法	ぶんかいじょうりゅうほう	Noun:|1. cracking (Chemistry term)
親気元素	しんきげんそ	Noun:|1. atmophile element (Geology, etc. term, Chemistry term)
複素環	ふくそかん	Noun, No-adjective:|1. heterocycle (Chemistry term)
機能性高分子	きのうせいこうぶんし	Noun:|1. functional polymer (Chemistry term)
鹵石	ろせき	Noun:|1. halide (Chemistry term)
環反転	かんはんてん	Noun:|1. ring inversion; ring flip (Chemistry term)
相律	そうりつ	Noun:|1. phase rule (Chemistry term)
超塩基	ちょうえんき	Noun:|1. superbase (Chemistry term)
強塩基	きょうえんき	Noun:|1. strong base (Chemistry term)
酸素族元素	さんそぞくげんそ	Noun:|1. oxygen family element; chalcogen (Chemistry term)
糖原	とうげん	Noun:|1. glycogen (Chemistry term)
環	かん	Noun:|1. ring (Mathematics, Chemistry term)
粘液酸	ねんえきさん	Noun:|1. mucic acid (Chemistry term)
溶質	ようしつ	Noun:|1. solute (Chemistry term)
重量法	じゅうりょうほう	Noun:|1. gravimetric method (Chemistry term)
シン	Noun - used as a prefix:|1. syn- (Chemistry term)
基	き	Noun:|1. group (Chemistry term)
熱化学	ねつかがく	Noun:|1. thermochemistry (Chemistry term)
水素イオン指数	すいそイオンしすう	Noun:|1. pH (Chemistry term)
懸濁液	けんだくえき	Noun:|1. suspension (Chemistry term)
ハロゲン化物	ハロゲンかぶつ	Noun:|1. halide; halogenide (Chemistry term)
ヨウ素酸	ヨウそさん	Noun:|1. iodic acid (Chemistry term)
クマリン	Noun:|1. coumarin (Chemistry term)
包接水和物	ほうせつすいわぶつ	Noun:|1. clathrate hydrate (Chemistry term)
炭酸バリウム	たんさんバリウム	Noun:|1. barium carbonate (Chemistry term)
炎色反応	えんしょくはんのう	Noun:|1. flame reaction; flame test; flame coloration test (Chemistry term)
フィセチン	Noun:|1. fisetin (Chemistry term)
アントシアニン	Noun:|1. anthocyanin (Chemistry term)
ジエン	Noun:|1. diene (Chemistry term)
クラウンエーテル	Noun:|1. crown ether; macrocyclic polyether (Chemistry term)
アニソール	Noun:|1. anisole (Chemistry term)
ケトン	Noun:|1. ketone (Chemistry term)
ジホスフィン	Noun:|1. diphosphine; diphosphane; P2H4 (Chemistry term)
共重合	きょうじゅうごう	Noun:|1. copolymerization; interpolymerization (Chemistry term)
硫酸ナトリウム	りゅうさんナトリウム	Noun:|1. sodium sulfate; sodium sulphate (Chemistry term)
ラウールの法則	ラウールのほうそく	Noun:|1. Raoult's law (Chemistry term)
リグナン	Noun:|1. lignan (Chemistry term)
環式化合物	かんしきかごうぶつ	Noun:|1. cyclic compound; ring compound (Chemistry term)
ホウケイ酸ガラス	ホウケイさんガラス	Noun:|1. borosilicate glass (Chemistry term)
ジメチルアミン	Noun:|1. dimethylamine (Chemistry term)
ロラタジン	Noun:|1. loratadine (antihistamine) (Chemistry term)
ジホスフィン	Noun:|1. diphosphine; diphosphane; P2H4 (Chemistry term)
共重合	きょうじゅうごう	Noun:|1. copolymerization; interpolymerization (Chemistry term)
硫酸ナトリウム	りゅうさんナトリウム	Noun:|1. sodium sulfate; sodium sulphate (Chemistry term)
ラウールの法則	ラウールのほうそく	Noun:|1. Raoult's law (Chemistry term)
ヒュッケル則	ヒュッケルそく	Noun:|1. Hückel's rule (Chemistry term)
カンナビノイド	Noun:|1. cannabinoid (Chemistry term)
超アクチノイド元素	ちょうアクチノイドげんそ	Noun:|1. transactinide elements; transactinides; super-heavy elements (Chemistry term)
アクチニド	Noun, Noun or verb acting prenominally:|1. actinide (family of elements); actinides; actinoid (Chemistry term)
トランスフェリン	Noun:|1. transferrin (Chemistry term)
メイラード反応	メイラードはんのう	Noun:|1. Maillard reaction (Chemistry term)
エキシマ	Noun:|1. excimer (Chemistry term)
アダムサイト	Noun:|1. adamsite (Chemistry term)
オリゴ糖	オリゴとう	Noun:|1. oligosaccharide (sugar polymer containing several but not many component simple sugars) (Chemistry term)
ケト酸	ケトさん	Noun:|1. keto acid; oxoacid (Chemistry term)
高速液体クロマトグラフィー	こうそくえきたいクロマトグラフィー	Noun:|1. high-performance liquid chromatography; high-pressure liquid chromatography; HPLC (Chemistry term)
オリゴ糖	オリゴとう	Noun:|1. oligosaccharide (sugar polymer containing several but not many component simple sugars) (Chemistry term)
ケト酸	ケトさん	Noun:|1. keto acid; oxoacid (Chemistry term)
高速液体クロマトグラフィー	こうそくえきたいクロマトグラフィー	Noun:|1. high-performance liquid chromatography; high-pressure liquid chromatography; HPLC (Chemistry term)
ツジョン	Noun:|1. thujone (Chemistry term)
メタンハイドレート	Noun:|1. methane hydrate (Chemistry term)
合成ガス	ごうせいガス	Noun:|1. syngas; synthesis gas (Chemistry term)
グラウバー塩	グラウバーえん	Noun:|1. Glauber's salt; sodium sulfate decahydrate; sodium sulphate decahydrate (Chemistry term, Obscure term)
ヘキソキシ	Noun:|1. hexoxy (Chemistry term)
フラックス	Noun:|1. flux (Chemistry term, Physics terminology)
イソ	Prefix:|1. iso- (Chemistry term)
カルコゲン	Noun:|1. chalcogen (Chemistry term)
空気ガス	くうきガス	Noun:|1. mixture of air and hydrocarbon gas or vapour (Chemistry term)
キャピラリー	Noun:|1. capillary (Chemistry term)
シアリダーゼ	Noun:|1. sialidase (Chemistry term)
トリトン	Noun:|1. triton (nucleus of tritium) (Chemistry term)
コンドロイチン	Noun:|1. chondroitin (Chemistry term)
ごまリグナン	Noun:|1. sesame lignan (Chemistry term, Usually written using kana alone)
リン化水素	リンかすいそ	Noun:|1. phosphine; phosphane; PH3; hydrogen phosphide; phosphorus trihydride (Chemistry term)
アサリニン	Noun:|1. asarinin (Chemistry term)
クラスレート化合物	クラスレートかごうぶつ	Noun:|1. clathrate compound (Chemistry term)
化学種	かがくしゅ	Noun:|1. chemical species (Chemistry term)
クプレイン	Noun:|1. cupreine; hydroxycinchonine (Chemistry term)
グロッケ	Noun:|1. bell jar; bell glass (Chemistry term)
フリース転移	フリースてんい	Noun:|1. Fries rearrangement (Chemistry term)
価	か	Noun - used as a suffix, Counter:|1. valence; valency (Chemistry term)
ラセミ分割	ラセミぶんかつ	Noun:|1. chiral resolution; optical resolution; racemic resolution (Chemistry term)
アラールキル	Noun:|1. aralkyl (Chemistry term)
トリクロル酢酸	トリクロルさくさん	Noun:|1. trichloroacetic acid; TCA; TCAA (Chemistry term)
ポリイソプレン	Noun:|1. polyisoprene (Chemistry term)
ラウリル	Noun:|1. lauryl (Chemistry term)
フリッピング	Noun:|1. flipping; ring inversion (Chemistry term)
ノイラミニダーゼ	Noun:|1. neuraminidase (Chemistry term)
バーゼ	Noun:|1. base (Chemistry term)
アクティベータ	Noun:|1. activator (Chemistry term)
脱アセチル化	だつアセチルか	Noun:|1. deacetylation (Chemistry term)
ジメチルアミノ	Noun or verb acting prenominally:|1. dimethylamino (Chemistry term)
副反応	ふくはんのう	Noun:|1. side reaction (Chemistry term, Medicine, etc. term)
力価	りきか	Noun:|1. titer; titre; potency (Chemistry term)
亜アンチモン酸	あアンチモンさん	Noun:|1. antimonious acid; antimonous acid (Chemistry term)
ホウケイ酸	ホウケイさん	Noun:|1. borosilicic acid (Chemistry term)
ホウケイ酸	ホウケイさん	Noun:|1. borosilicic acid (Chemistry term)
ホウケイ酸塩	ホウケイさんえん	Noun:|1. borosilicate (Chemistry term)
鎖状化合物	さじょうかごうぶつ	Noun:|1. open-chain compound; acyclic compound (Chemistry term)
パリスグリーン	Noun:|1. Paris green (Chemistry term)
レアアース	Noun:|1. rare-earth element (Chemistry term)
炭酸鉛	たんさんなまり	Noun:|1. lead carbonate (Chemistry term)
マテリアルバランス	Noun:|1. material balance (Chemistry term)
増成	ぞうせい	Noun:|1. Aufbau (principle) (Chemistry term)
マテバラ	Noun:|1. material balance (Chemistry term, Abbreviation)
カンナビノール	Noun:|1. cannabinol (Chemistry term)
サーチュイン	Noun:|1. sirtuin (Chemistry term)
エナンチオ	Noun - used as a prefix:|1. enantio (Chemistry term)
エナンチオトピック	Noun, No-adjective:|1. enantiotopic (Chemistry term)
エナンチオトロピー	Noun:|1. enantiotropy (Chemistry term)
エナンチオマー	Noun:|1. enantiomer (Chemistry term)
水素イオン濃度	すいそイオンのうど	Noun:|1. hydrogen ion concentration (Chemistry term)
キラル	Noun or verb acting prenominally:|1. chiral (Chemistry term)
酸化ヒ素	さんかヒそ	Noun:|1. arsenic trioxide; white arsenic (As2O3) (Chemistry term)
Ｘ線回折	エックスせんかいせつ	Noun:|1. X-ray diffraction (Chemistry term, Physics terminology)