上げる	あげる	Ichidan verb, Transitive verb:|1. to raise; to elevate|2. to do up (one's hair)|3. to fly (a kite, etc.); to launch (fireworks, etc.); to surface (a submarine, etc.)|4. to land (a boat)|5. to deep-fry|6. to show someone (into a room)|7. to summon (for geishas, etc.) (Usually written using kana alone)|8. to send someone (away)|9. to enrol (one's child in school); to enroll|10. to increase (price, quality, status, etc.); to develop (talent, skill); to improve|11. to make (a loud sound); to raise (one's voice)|12. to earn (something desirable)|13. to praise|14. to give (an example, etc.); to cite (usu. 挙げる)|15. to summon up (all of one's energy, etc.) (usu. 挙げる)|16. to arrest|17. to nominate|18. to give (Polite (teineigo))|19. to offer up (incense, a prayer, etc.) to the gods (or Buddha, etc.)|20. to bear (a child)|21. to conduct (a ceremony, esp. a wedding) (usu. 挙げる)||Ichidan verb, intransitive verb:|22. (of the tide) to come in||Ichidan verb, intransitive verb, Transitive verb:|23. to vomit||Auxiliary verb, Ichidan verb:|24. to do for (the sake of someone else) (Usually written using kana alone, Polite (teineigo)) (after the -te form of a verb)|25. to complete ... (after the -masu stem of a verb)|26. to humbly do ... (Humble (kenjougo)) (after the -masu stem of a humble verb to increase the level of humility)||Wikipedia definition:|27. Deep frying
腕	うで	Noun:|1. arm|2. skill; efforts; ability||Wikipedia definition:|3. Arm
人形	にんぎょう	Noun:|1. doll; puppet; figure||Wikipedia definition:|2. Doll
文化	ぶんか	Noun:|1. culture; civilization; civilisation|2. Bunka era (1804.2.11-1818.4.22)||Wikipedia definition:|3. Culture
海岸	かいがん	Noun, No-adjective:|1. coast; beach||Wikipedia definition:|2. Coast
産業	さんぎょう	Noun, No-adjective:|1. industry||Noun:|2. livelihood; occupation (Archaism)||Wikipedia definition:|3. Industry
動物園	どうぶつえん	Noun:|1. zoo; zoological gardens||Wikipedia definition:|2. Zoo
美術館	びじゅつかん	Noun:|1. art gallery; art museum||Wikipedia definition:|2. Art museum
水道	すいどう	Noun:|1. water supply; water service; waterworks|2. channel; strait|3. water course; waterway||Wikipedia definition:|4. Water supply
飛行場	ひこうじょう	Noun:|1. airfield; airport||Wikipedia definition:|2. Aerodrome
ぶどう	Noun:|1. grape; grapevine (Usually written using kana alone)||Wikipedia definition:|2. Grape
事故	じこ	Noun:|1. accident; incident; trouble|2. circumstances; reasons||Wikipedia definition:|3. Accident
息子	むすこ	Noun:|1. son|2. penis (Vulgar)||Wikipedia definition:|3. Son
生活	せいかつ	Noun, Suru verb:|1. living; life (one's daily existence); livelihood||Wikipedia definition:|2. Seikatsu
注意	ちゅうい	Noun, Suru verb:|1. caution; being careful; attention (heed); warning; advice||Wikipedia definition:|2. Attention
生きる	いきる	Ichidan verb, intransitive verb:|1. to live; to exist|2. to make a living; to subsist|3. to be in effect; to be in use; to function|4. to come to life; to be enlivened|5. to be safe (in baseball, go, etc.)||Wikipedia definition:|6. To Live (film)
女性	じょせい	Noun, No-adjective:|1. woman; female|2. feminine gender (linguistics terminology)||Wikipedia definition:|3. Woman
船	ふね	Noun:|1. ship; boat; watercraft; vessel; steamship (舟 is often small and hand-propelled)|2. tank; tub; vat; trough||Noun - used as a suffix, Counter:|3. counter for boat-shaped containers (e.g. of sashimi)||Wikipedia definition:|4. Ship
説明	せつめい	Noun, Suru verb, No-adjective:|1. explanation; exposition||Wikipedia definition:|2. Explanation
警察	けいさつ	Noun, No-adjective:|1. police|2. police officer (Abbreviation)|3. police station (Abbreviation)||Wikipedia definition:|4. Police
危険	きけん	Noun, Na-adjective:|1. danger; peril; hazard|2. risk||Wikipedia definition:|3. Danger
世界	せかい	Noun:|1. the world; society; the universe|2. sphere; circle; world||No-adjective:|3. renowned; world-famous; well-known outside of Japan||Noun:|4. realm governed by one Buddha; space (Buddhist term) (original meaning)||Wikipedia definition:|5. World
戦争	せんそう	Noun, Suru verb:|1. war|2. fighting; fierce competition||Wikipedia definition:|3. War
小説	しょうせつ	Noun, No-adjective:|1. novel; (short) story||Wikipedia definition:|2. Novel
関係	かんけい	Noun, Suru verb, No-adjective:|1. relation; relationship; connection|2. participation; involvement; concern|3. influence; effect||Noun, Suru verb:|4. sexual relations; sexual relationship||Noun - used as a suffix:|5. related to; connected to||Wikipedia definition:|6. Relation
研究	けんきゅう	Noun, Suru verb:|1. study; research; investigation||Wikipedia definition:|2. Research
会議	かいぎ	Noun, Suru verb, No-adjective:|1. meeting; conference; session; assembly; council; convention; congress||Wikipedia definition:|2. Meeting
音	おと	Noun, Noun - used as a suffix:|1. sound; noise; report|2. note (Music term)|3. fame|4. Chinese-derived character reading||Wikipedia definition:|5. Sound
普通	ふつう	No-adjective:|1. general; ordinary; usual||Adverb:|2. normally; generally; usually||Noun:|3. local train; train that stops at every station (Abbreviation)||Wikipedia definition:|4. Normality (behavior)
湖	みずうみ	Noun:|1. lake||Wikipedia definition:|2. Lake
夢	ゆめ	Noun:|1. dream||Wikipedia definition:|2. Dream
空港	くうこう	Noun:|1. airport||Wikipedia definition:|2. Airport
数学	すうがく	Noun:|1. mathematics; arithmetic||Wikipedia definition:|2. Mathematics
教育	きょういく	Noun, Suru verb:|1. education; schooling; training; instruction; teaching; upbringing|2. culture; cultivation; education||Wikipedia definition:|3. Education
赤ちゃん	あかちゃん	Noun:|1. baby; infant||Wikipedia definition:|2. Infant
自由	じゆう	Expression, Na-adjective, Noun:|1. freedom; liberty; as it pleases you||Wikipedia definition:|2. Liberty
火	ひ	Noun, Noun - used as a suffix:|1. fire; flame; blaze||Wikipedia definition:|2. Fire
森	もり	Noun:|1. forest|2. shrine grove (esp. 杜)||Wikipedia definition:|3. Mori
法律	ほうりつ	Noun, No-adjective:|1. law||Wikipedia definition:|2. Statute
気分	きぶん	Noun:|1. feeling; mood||Wikipedia definition:|2. Mood (psychology)
壁	かべ	Noun:|1. wall; partition|2. barrier; obstacle|3. Chinese "Wall" constellation (one of the 28 mansions) (Astronomy, etc. term)||Wikipedia definition:|4. Wall
田舎	いなか	Noun, No-adjective:|1. rural area; countryside; the sticks (Sensitive)|2. hometown||Wikipedia definition:|3. Rural area
気	き	Noun:|1. spirit; mind; heart|2. nature; disposition|3. motivation; intention (usu. after a verb)|4. mood; feelings|5. ambience; atmosphere; mood||Wikipedia definition:|6. Qi
男性	だんせい	Noun, No-adjective:|1. man; male|2. masculine gender (linguistics terminology)||Wikipedia definition:|3. Man
地震	じしん	Noun:|1. earthquake||Wikipedia definition:|2. Earthquake
故障	こしょう	Noun, Suru verb:|1. breakdown; failure; fault; accident; out of order|2. damage; hurt|3. objection; protest||Wikipedia definition:|4. Failure
人口	じんこう	Noun:|1. population|2. common talk||Wikipedia definition:|3. Population
残念	ざんねん	Na-adjective, Noun:|1. deplorable; regrettable; disappointing; vexing; unfortunate||Wikipedia definition:|2. Regret (emotion)
島	しま	Noun:|1. island|2. territory (of a prostitute, organized crime gang, etc.); turf (Usually written using kana alone)||Wikipedia definition:|3. Island
歴史	れきし	Noun, No-adjective:|1. history||Wikipedia definition:|2. History
教会	きょうかい	Noun:|1. church; congregation||Wikipedia definition:|2. Christian Church
社会	しゃかい	Noun:|1. society; public; community; the world|2. social studies (Abbreviation)||Wikipedia definition:|3. Society
住所	じゅうしょ	Noun:|1. address (e.g. of house); residence; domicile||Wikipedia definition:|2. Address (geography)
工場	こうじょう	Noun:|1. factory; plant; mill; workshop||Wikipedia definition:|2. Factory
趣味	しゅみ	Noun:|1. hobby; pastime|2. tastes; preference; liking||Wikipedia definition:|3. Hobby
経済	けいざい	Noun, Suru verb:|1. economics; business; finance; economy||Wikipedia definition:|2. Economy
台風	たいふう	Noun:|1. typhoon; hurricane||Wikipedia definition:|2. Typhoon
卒業	そつぎょう	Noun, Suru verb:|1. graduation; completion (e.g. of a course)|2. outgrowing something; moving on (from)||Wikipedia definition:|3. Graduation
雲	くも	Noun:|1. cloud||Wikipedia definition:|2. Cloud
科学	かがく	Noun:|1. science||Wikipedia definition:|2. Science
贈り物	おくりもの	Noun:|1. present; gift||Wikipedia definition:|2. Gift
科学	かがく	Noun:|1. science||Wikipedia definition:|2. Science
政治	せいじ	Noun:|1. politics; government||Wikipedia definition:|2. Politics
特別	とくべつ	Na-adjective, No-adjective, Adverb, Noun:|1. special; particular; extraordinary; exceptional; especial||Wikipedia definition:|2. Particular
水泳	すいえい	Noun, Suru verb, No-adjective:|1. swimming||Wikipedia definition:|2. Human swimming
講義	こうぎ	Noun, Suru verb:|1. lecture||Wikipedia definition:|2. Lecture
指	ゆび	Noun:|1. finger; toe; digit||Wikipedia definition:|2. Finger
生産	せいさん	Noun, Suru verb:|1. production; manufacture||Wikipedia definition:|2. Outline of industrial organization
会話	かいわ	Noun, Suru verb:|1. conversation||Wikipedia definition:|2. Conversation
季節	きせつ	Noun, No-adjective:|1. season; time of year||Wikipedia definition:|2. Season
おもちゃ	Noun:|1. toy; plaything (Usually written using kana alone)||Wikipedia definition:|2. Toy
翻訳	ほんやく	Noun, Suru verb:|1. translation|2. de-encryption; deciphering|3. rendering||Wikipedia definition:|4. Translation
貿易	ぼうえき	Noun, Suru verb:|1. trade (foreign)||Wikipedia definition:|2. International trade
文学	ぶんがく	Noun:|1. literature||Wikipedia definition:|2. Literature
葉	は	Noun:|1. leaf; blade (of grass); (pine) needle||Wikipedia definition:|2. Leaf
交通	こうつう	Noun, Suru verb:|1. traffic; transportation; communication; exchange (of ideas, etc.); intercourse||Wikipedia definition:|2. Transport
遊び	あそび	Noun, Noun - used as a suffix:|1. playing|2. play (margin between on and off, gap before pressing button or lever has an effect) (Usually written using kana alone)||Wikipedia definition:|3. Play (activity)
道具	どうぐ	Noun:|1. tool; implement; instrument; utensil; apparatus; device|2. means|3. furniture||Wikipedia definition:|4. Tool
入学	にゅうがく	Noun, Suru verb:|1. entry to school or university; matriculation; enrolment (in university, etc.) (enrollment)||Wikipedia definition:|2. Matriculation
背中	せなか	Noun:|1. back (of body)||Wikipedia definition:|2. Human back
指輪	ゆびわ	Noun:|1. (finger) ring||Wikipedia definition:|2. Ring (jewellery)
発音	はつおん	Noun, Suru verb:|1. pronunciation|2. production of sound||Wikipedia definition:|3. Pronunciation
医学	いがく	Noun:|1. medical science; medicine||Wikipedia definition:|2. Medicine
漫画	まんが	Noun:|1. cartoon; comic; comic strip||Wikipedia definition:|2. Comics
鏡	かがみ	Noun:|1. mirror; looking-glass|2. barrel head||Wikipedia definition:|3. Mirror
電報	でんぽう	Noun:|1. telegram||Wikipedia definition:|2. Telegraphy
校長	こうちょう	Noun:|1. principal; headmaster||Wikipedia definition:|2. Head teacher
郊外	こうがい	Noun, No-adjective:|1. suburb; outskirts||Wikipedia definition:|2. Suburb
市民	しみん	Noun:|1. citizen; citizenry; public|2. city inhabitant; townspeople|3. bourgeoisie; middle class||Wikipedia definition:|4. Citizenship
砂	すな	Noun:|1. sand; grit|2. gold dust; silver dust||Wikipedia definition:|3. Sand
手袋	てぶくろ	Noun:|1. glove; mitten; mitt||Wikipedia definition:|2. Glove
絹	きぬ	Noun:|1. silk||Wikipedia definition:|2. Silk
日記	にっき	Noun:|1. diary; journal||Wikipedia definition:|2. Diary
文法	ぶんぽう	Noun, No-adjective:|1. grammar; syntax (linguistics terminology)||Wikipedia definition:|2. Grammar
糸	いと	Noun, Noun - used as a suffix:|1. thread; yarn; string||Wikipedia definition:|2. Yarn
神社	じんじゃ	Noun:|1. Shinto shrine||Wikipedia definition:|2. Shinto shrine
展覧会	てんらんかい	Noun:|1. exhibition||Wikipedia definition:|2. Art exhibition
駐車場	ちゅうしゃじょう	Noun:|1. parking lot; parking place||Wikipedia definition:|2. Parking lot
小学校	しょうがっこう	Noun:|1. primary school; elementary school; grade school||Wikipedia definition:|2. Primary school
西洋	せいよう	Noun, No-adjective:|1. the west; Western countries||Wikipedia definition:|2. Western world
西洋	せいよう	Noun, No-adjective:|1. the west; Western countries||Wikipedia definition:|2. Western world
坂	さか	Noun:|1. slope; hill||Wikipedia definition:|2. Grade (slope)
注射	ちゅうしゃ	Noun, Suru verb:|1. injection||Wikipedia definition:|2. Injection (medicine)
乗り物	のりもの	Noun:|1. vehicle; conveyance; transport|2. ride (playground, fair, carnival); playground facility||Wikipedia definition:|3. Vehicle
旅館	りょかん	Noun:|1. ryokan; Japanese-style lodging, usu. professionally-run||Wikipedia definition:|2. Ryokan (Japanese inn)
林	はやし	Noun:|1. woods; forest; copse; thicket|2. bunch; line (of something); collection||Wikipedia definition:|3. Hayashi
布団	ふとん	Noun:|1. futon (quilted Japanese-style mattress laid out on the floor)|2. round cushion used for Zen meditation (traditionally made of woven bulrush leaves)||Wikipedia definition:|3. Futon
柔道	じゅうどう	Noun:|1. judo||Wikipedia definition:|2. Judo
会議室	かいぎしつ	Noun:|1. conference room; council room||Wikipedia definition:|2. Conference hall
研究室	けんきゅうしつ	Noun:|1. laboratory|2. seminar room|3. professor's office||Wikipedia definition:|4. Laboratory
中学校	ちゅうがっこう	Noun:|1. junior high school; middle school; lower secondary school||Wikipedia definition:|2. Middle school
高等学校	こうとうがっこう	Noun:|1. senior high school; high school||Wikipedia definition:|2. High school
花見	はなみ	Noun, Suru verb:|1. cherry blossom viewing; flower viewing||Wikipedia definition:|2. Hanami
公務員	こうむいん	Noun:|1. government worker; public servant; civil servant||Wikipedia definition:|2. Civil service
辞典	じてん	Noun:|1. dictionary; lexicon||Wikipedia definition:|2. Dictionary
心	こころ	Noun:|1. mind; heart; spirit|2. the meaning of a phrase (riddle, etc.)||Wikipedia definition:|3. Mind
力	ちから	Noun:|1. force; strength; might; vigour (vigor); energy|2. capability; ability; proficiency; capacity; faculty|3. efficacy; effect|4. effort; endeavours (endeavors); exertions|5. power; authority; influence; good offices; agency|6. support; help; aid; assistance|7. stress; emphasis|8. means; resources||Wikipedia definition:|9. Force
喧嘩	けんか	Noun, Suru verb:|1. quarrel; brawl; fight; squabble; scuffle; argument||Wikipedia definition:|2. Brawling (legal definition)
天気予報	てんきよほう	Noun:|1. weather forecast; weather report||Wikipedia definition:|2. Weather forecasting
ひげ	Noun:|1. moustache; beard; whiskers (Usually written using kana alone) (in careful usage 髭 for moustache, 鬚 for beard, 髯 for (cheek) whiskers)|2. whiskers (on a cat, etc.); feelers (on an insect, etc.); (chin) tuft|3. extremely short pulse appearing on an electrical signal||Wikipedia definition:|4. Beard
押し入れ	おしいれ	Noun:|1. closet||Wikipedia definition:|2. Closet
味噌	みそ	Noun:|1. miso; fermented condiment usu. made from soybeans (Food term)|2. innards (from crabs, shrimps, etc.) resembling miso|3. key (main) point; good part (of something)|4. weakling; weak person (Derogatory)||Wikipedia definition:|5. Miso
みんな	Adverb, Noun:|1. all; everyone; everybody (Usually written using kana alone)|2. everything (Usually written using kana alone)
明日	あした	Temporal noun:|1. tomorrow|2. near future
かける	Ichidan verb, Transitive verb:|1. to hang up (e.g. a picture on the wall); to let hang; to suspend (from); to hoist (e.g. sail); to raise (e.g. flag) (Usually written using kana alone)|2. to put on (e.g. a blanket); to put on top of; to cover (Usually written using kana alone)|3. to put on (glasses, etc.); to wear (a necklace, etc.) (Usually written using kana alone)|4. to make (a call) (Usually written using kana alone)|5. to spend (time, money); to expend; to use (Usually written using kana alone)|6. to pour (liquid) onto; to sprinkle (powder or spices) onto; to splash; to throw (e.g. water) onto somebody (Usually written using kana alone)|7. to turn on (an engine, radio, etc.); to set (a dial, an alarm clock, etc.); to put on (a DVD, a song, etc.) (Usually written using kana alone)|8. to cause (somebody inconvenience, trouble, etc.); to burden (someone); to impose (Usually written using kana alone)|9. to multiply (arithmetic operation) (Usually written using kana alone)|10. to secure (e.g. lock) (Usually written using kana alone)|11. to take a seat; to sit; to rest (something on something else); to support (something on something else) (Usually written using kana alone)|12. to bind (Usually written using kana alone) (also 繋ける)|13. to wager; to bet; to risk; to stake; to gamble (Usually written using kana alone)|14. to put an effect (spell, anaesthetic, etc.) on (Usually written using kana alone)|15. to hold (a play, festival, etc.) (Usually written using kana alone)|16. to hold an emotion for (pity, hope, etc.) (Usually written using kana alone)|17. to argue (in court); to deliberate (in a meeting); to present (e.g. idea to a conference, etc.) (Usually written using kana alone)|18. to increase further (Usually written using kana alone)|19. to catch (in a trap, etc.) (Usually written using kana alone)|20. to set atop (Usually written using kana alone)|21. to erect (a makeshift building) (Usually written using kana alone)|22. to apply (insurance) (Usually written using kana alone)|23. to pun (on a word); to use (a word) as a pivot word; to play on words (Usually written using kana alone)||Suffix, Ichidan verb:|24. to be partway doing ...; to begin (but not complete) ...; to be about to ... (Usually written using kana alone) (after -masu stem of verb)|25. to address (someone); to direct (something, to someone); to do (something, to someone) (Usually written using kana alone) (after -masu stem of verb; indicates (verb) is being directed to someone)
降りる	おりる	Ichidan verb, intransitive verb:|1. to descend (e.g. a mountain); to go down; to come down (esp. 下りる)|2. to alight (e.g. from bus); to get off; to disembark; to dismount (esp. 降りる)|3. to step down; to retire; to give up; to quit|4. to be granted; to be issued; to be given (esp. 下りる)|5. to form (of frost, dew, mist, etc.) (esp. 降りる)|6. to be passed (from the body; e.g. of a roundworm) (esp. 下りる)
彼	かれ	Pronoun:|1. he; him||Noun:|2. boyfriend
客	きゃく	Noun:|1. guest; visitor|2. customer; client; shopper; spectator; audience; tourist; sightseer; passenger
祖父	そふ	Noun, No-adjective:|1. grandfather|2. old man|3. kyogen mask used for the role of an old man
高校	こうこう	Noun:|1. senior high school; high school (Abbreviation)
近所	きんじょ	Noun, No-adjective:|1. neighbourhood; neighborhood
番組	ばんぐみ	Noun:|1. program (e.g. TV); programme
見物	けんぶつ	Noun, Suru verb:|1. sightseeing; watching; viewing||Noun:|2. sightseer; watcher; spectator (Abbreviation)
アメリカ	Noun:|1. America (Usually written using kana alone)|2. United States of America (Usually written using kana alone)
彼女	かのじょ	Pronoun:|1. she; her||Noun:|2. girlfriend
思う	おもう	Godan verb with u ending, Transitive verb:|1. to think; to consider; to believe; to reckon (想う has connotations of heart-felt)|2. to think (of doing); to plan (to do)|3. to judge; to assess; to regard|4. to imagine; to suppose; to dream|5. to expect; to look forward to|6. to feel; to be (in a state of mind); to desire; to want|7. to recall; to remember
僕	ぼく	Pronoun:|1. I; me (Male term or language)|2. you (used addressing young children)|3. manservant
必要	ひつよう	Na-adjective:|1. necessary; needed; essential; indispensable (必用 can imply has to be used rather than is just needed)||Noun:|2. necessity; need; requirement
見える	みえる	Ichidan verb, intransitive verb:|1. to be seen; to be in sight|2. to look; to seem; to appear|3. to come (Honorific or respectful (sonkeigo))
考える	かんがえる	Ichidan verb, Transitive verb:|1. to think (about, of); to think over; to ponder; to contemplate; to reflect (on); to meditate (on)|2. to consider; to bear in mind; to allow for; to take into consideration|3. to think (that); to believe; to hold (a view); to judge; to conclude; to suspect|4. to intend (to do); to think of (doing); to plan|5. to predict; to anticipate; to expect; to imagine|6. to come up with; to think up; to contrive; to devise|7. to consider (as); to regard (as); to look on (as); to take; to view
ため	Noun:|1. good; advantage; benefit; welfare (Usually written using kana alone)|2. sake; purpose; objective; aim (Usually written using kana alone)|3. consequence; result; effect (Usually written using kana alone)|4. affecting; regarding; concerning (Usually written using kana alone)
始める	はじめる	Ichidan verb, Transitive verb:|1. to start; to begin; to commence; to initiate; to originate|2. to open (e.g. a store); to start up; to establish (business. etc.)||Auxiliary verb, Ichidan verb:|3. to start ...; to begin to ... (after the -masu stem of a verb)
受ける	うける	Ichidan verb, Transitive verb:|1. to receive; to get|2. to catch (e.g. a ball)|3. to be struck by (wind, waves, sunlight, etc.)|4. to sustain (damage); to incur (a loss); to suffer (an injury); to feel (influence)|5. to undergo (e.g. surgery); to take (a test); to accept (a challenge)|6. to be given (e.g. life, talent) (esp. 受ける, 享ける)||Ichidan verb, intransitive verb:|7. to find funny; to find humorous; to be amused (by) (Colloquialism, Usually written using kana alone) (esp. ウケる)||Ichidan verb, Transitive verb:|8. to follow; to succeed; to be descended from (esp. 受ける, 享ける)|9. to face (south, etc.)|10. to be modified by (linguistics terminology) (esp. 受ける, 承ける)|11. to obtain (a pawned item, etc.) by paying a fee (esp. 請ける, now primarily used in compound words)||Ichidan verb, intransitive verb:|12. to be well-received; to become popular; to go down well (Usually written using kana alone) (esp. ウケる, うける)
美しい	うつくしい	I-adjective:|1. beautiful; lovely
試験	しけん	Noun, Suru verb:|1. examination; exam; test|2. trial; experiment; test
親切	しんせつ	Na-adjective, Noun:|1. kind; gentle; considerate; generous; friendly; nice
失敗	しっぱい	Noun, No-adjective, Suru verb:|1. failure; mistake; blunder
以上	いじょう	Adverbial noun, Temporal noun:|1. not less than; ... and more; ... and upwards|2. beyond ... (e.g. one's means); further (e.g. nothing further to say); more than ... (e.g. cannot pay more than that)|3. above-mentioned; foregoing|4. since ...; seeing that ...|5. this is all; that is the end; the end
意見	いけん	Noun, Suru verb, No-adjective:|1. opinion; view; comment
決して	けっして	Adverb:|1. never; by no means; not in the least; in no way (with neg. verb)
十分	じゅうぶん	Na-adjective:|1. enough; sufficient; plenty; adequate; satisfactory||Adverb:|2. sufficiently; fully; thoroughly; well; perfectly||Noun, Suru verb:|3. division into ten
試合	しあい	Noun, Suru verb:|1. match; game; bout; contest
一生懸命	いっしょうけんめい	Na-adjective, Adverbial noun, Noun:|1. very hard; with utmost effort; with all one's might; for dear life (Yojijukugo (four character compound))
子	こ	Noun, Noun - used as a suffix:|1. child|2. young (animal)|3. young woman; young geisha (also 娘)|4. offshoot|5. interest|6. new shares (Abbreviation)||Noun:|7. player who is not a dealer (in cards, mahjong, etc.)||Noun, Noun - used as a suffix:|8. bird egg (Archaism)||Noun - used as a suffix:|9. -er (often of young women) (after a noun or -masu stem)
探す	さがす	Godan verb with su ending, Transitive verb:|1. to search (for something desired, needed); to look for (esp. 探す)|2. to search (for something lost); to seek (a suspect in a crime) (esp. 捜す)
急ぐ	いそぐ	Godan verb with gu ending, intransitive verb, Transitive verb:|1. to hurry; to rush; to hasten; to make something happen sooner
選ぶ	えらぶ	Godan verb with bu ending, Transitive verb:|1. to choose; to select
送る	おくる	Godan verb with ru ending, Transitive verb:|1. to send (a thing); to dispatch; to despatch; to transmit|2. to take or escort (a person somewhere); to see off (a person)|3. to bid farewell (to the departed); to bury|4. to spend (time); to live one's life|5. to pass (down the line)|6. to affix okurigana
必ず	かならず	Adverb:|1. always; without exception; necessarily; certainly; without fail; positively; invariably
怒る	おこる	Godan verb with ru ending, intransitive verb:|1. to get angry; to get mad||Godan verb with ru ending, Transitive verb:|2. to tell someone off; to scold||Godan verb with ru ending, intransitive verb:|3. to be angular; to be square
最近	さいきん	Adverbial noun, Temporal noun, No-adjective:|1. recently; lately; these days; nowadays; right now||No-adjective:|2. nearest; closest
払う	はらう	Godan verb with u ending, Transitive verb:|1. to pay (e.g. money, bill)|2. to brush off; to wipe away; to clear away; to dust off; to cut off (e.g. branches)|3. to drive away (e.g. one's competitors)|4. to sell off (something unneeded); to dispose of|5. to pay (e.g. attention); to show (e.g. respect, concern)|6. to make (e.g. effort, sacrifice); to expend; to exert|7. to move out (of one's own place); to vacate|8. to sweep (e.g. one's legs); to knock aside|9. to make a sweeping stroke (in Japanese calligraphy)|10. to reset (an abacus)
合う	あう	Godan verb with u ending, intransitive verb:|1. to come together; to merge; to unite; to meet|2. to fit; to match; to suit; to agree with; to be correct|3. to be profitable; to be equitable||Auxiliary verb, Godan verb with u ending:|4. to do ... to each other; to do ... together (after the -masu stem of a verb)
点	てん	Noun, Noun - used as a suffix:|1. spot; mark|2. point; dot|3. mark (e.g. in exam); score; points||Noun:|4. comma|5. aspect; matter; respect||Counter:|6. counter for goods, items, articles of clothing, works of art, etc.
決める	きめる	Ichidan verb, Transitive verb:|1. to decide; to choose; to determine; to make up one's mind; to resolve; to set one's heart on; to settle; to arrange; to set; to appoint; to fix|2. to clinch (a victory); to decide (the outcome of a match)|3. to persist in doing; to go through with|4. to always do; to have made a habit of (as 決めている)|5. to take for granted; to assume|6. to dress up; to dress to kill; to dress to the nines|7. to carry out successfully (a move in sports, a pose in dance, etc.); to succeed in doing|8. to immobilize with a double-arm lock (in sumo, judo, etc.) (Martial arts term, Sumo term)|9. to eat or drink something; to take illegal drugs
笑う	わらう	Godan verb with u ending, intransitive verb:|1. to laugh|2. to smile|3. to sneer; to ridicule (esp. 嗤う)|4. to be dumbfounded; to be flabbergasted (as 笑ってしまう or 笑っちゃう)
最初	さいしょ	No-adjective, Adverbial noun, Temporal noun:|1. beginning; outset; first; onset
反対	はんたい	Noun, Suru verb, No-adjective, Na-adjective:|1. opposition; resistance; antagonism; hostility; objection; dissent||Noun, No-adjective:|2. reverse; opposite; inverse; contrary
妻	つま	Noun:|1. wife|2. my dear; dear; honey (Archaism)|3. garnish (esp. one served with sashimi) (Usually written using kana alone)|4. embellishment (Usually written using kana alone)
娘	むすめ	Noun:|1. (my) daughter|2. girl (i.e. a young, unmarried woman)
喜ぶ	よろこぶ	Godan verb with bu ending:|1. to be delighted; to be glad; to be pleased|2. to congratulate|3. to gratefully accept
理由	りゆう	Noun:|1. reason; pretext; motive
昔	むかし	No-adjective, Adverbial noun, Temporal noun:|1. olden days; former
約束	やくそく	Noun, Suru verb:|1. promise; agreement; arrangement; one's word; contract; pact; appointment; engagement; date|2. convention; rule|3. destiny; fate
思い出す	おもいだす	Godan verb with su ending, Transitive verb:|1. to recall; to remember; to recollect
正しい	ただしい	I-adjective:|1. right; correct|2. proper; righteous; just; honest; truthful; lawful
落ちる	おちる	Ichidan verb, intransitive verb:|1. to fall down; to drop; to fall (e.g. rain); to sink (e.g. sun or moon); to fall onto (e.g. light or one's gaze); to be used in a certain place (e.g. money)|2. to be omitted; to be missing|3. to decrease; to sink|4. to fail (e.g. exam or class); to lose (contest, election, etc.)|5. to crash; to degenerate; to degrade; to fall behind|6. to become indecent (of a conversation)|7. to be ruined; to go under|8. to fade; to come out (e.g. a stain); to come off (e.g. makeup); to be removed (e.g. illness, possessing spirit, name on a list)|9. to fall (into someone's hands); to become someone's possession|10. to fall (into a trap); to fall (for a trick)|11. to give in; to give up; to confess; to flee|12. to fall; to be defeated; to surrender|13. to come to (in the end); to end in|14. to fall (in love, asleep, etc.)|15. to swoon (judo)|16. to consent; to understand|17. to crash; to freeze (Computer terminology)|18. to die (of animals)|19. to move to the depths (of fish when it gets cold)
場所	ばしょ	Noun:|1. place; location; spot; position|2. room; space|3. basho; wrestling tournament (Sumo term)
楽しむ	たのしむ	Godan verb with mu ending:|1. to enjoy (oneself)
利用	りよう	Noun, Suru verb:|1. use; utilization; utilisation; application
間に合う	まにあう	Godan verb with u ending, intransitive verb:|1. to be in time for|2. to serve (suit, meet) the purpose; to be good enough; to be enough
今度	こんど	Adverbial noun, Temporal noun:|1. this time; now|2. next time; another time; shortly; soon|3. recently; previous; last
予定	よてい	Noun, Suru verb:|1. plans; arrangement; schedule; program; programme; expectation; estimate
訪ねる	たずねる	Ichidan verb, Transitive verb:|1. to visit; to call on; to pay a visit to
赤ん坊	あかんぼう	Noun:|1. baby; infant
進む	すすむ	Godan verb with mu ending, intransitive verb:|1. to advance; to go forward|2. to precede; to go ahead (of)|3. to make progress; to improve|4. to deepen; to heighten|5. to be fast (of a clock); to be ahead|6. to do of one's own free will
最後	さいご	Noun:|1. end; conclusion||No-adjective:|2. last; final; latest; most recent||Expression:|3. no sooner than; once; right after (often having negative consequences) (after -tara form or -ta form followed by "ga")||Noun:|4. one's final moments (Archaism)
向かう	むかう	Godan verb with u ending, intransitive verb:|1. to face|2. to go towards; to head towards
通る	とおる	Godan verb with ru ending, intransitive verb:|1. to go by; to go past; to go along; to travel along; to pass through; to use (a road); to take (a route); to go via; to go by way of|2. to run (between); to operate (between); to connect (of public transport)|3. to go indoors; to go into a room; to be admitted; to be shown in; to be ushered in; to come in|4. to penetrate; to pierce; to skewer; to go through; to come through|5. to permeate; to soak into; to spread throughout|6. to carry (e.g. of a voice); to reach far|7. to be passed on (e.g. of a customer's order to the kitchen); to be relayed; to be conveyed|8. to pass (a test, a bill in the House, etc.); to be approved; to be accepted|9. to go by (a name); to be known as; to be accepted as; to have a reputation for|10. to be coherent; to be logical; to be reasonable; to be comprehensible; to be understandable; to make sense|11. to get across (e.g. of one's point); to be understood|12. to be straight (e.g. wood grain)|13. to be well-informed; to be wise (Archaism)||Suffix, Godan verb with ru ending:|14. to do ... completely; to do ... thoroughly (after the -masu stem of a verb)
興味	きょうみ	Noun:|1. interest (in something); curiosity (about something); zest (for)
時代	じだい	Temporal noun, Noun:|1. period; epoch; era; age|2. the times; those days|3. oldness; ancientness; antiquity|4. antique; period piece (Abbreviation)
返事	へんじ	Noun, Suru verb:|1. reply; answer; response
気持ち	きもち	Noun:|1. feeling; sensation; mood|2. preparedness; readiness; attitude|3. thanks; solicitude; sympathy (Humble (kenjougo))||Adverb:|4. just a little; somewhat; slightly
途中	とちゅう	Adverbial noun, Temporal noun:|1. on the way; en route|2. in the middle of; midway
簡単	かんたん	Na-adjective, Noun:|1. simple; easy; uncomplicated|2. brief; quick; light
深い	ふかい	I-adjective:|1. deep|2. profound|3. dense; thick|4. close (relationship)|5. intense; strong|6. late
起こす	おこす	Godan verb with su ending, Transitive verb:|1. to raise; to raise up; to set up; to pick up|2. to wake; to wake up; to waken; to awaken|3. to cause; to bring about; to lead to; to trigger; to give rise to; to create; to generate (e.g. heat, electricity); to produce|4. to start; to begin; to launch; to establish; to found; to set up; to open|5. to plough; to plow; to till|6. to fall ill with|7. to transcribe; to write down (what is spoken)|8. to turn over (a card)
夫	おっと	Noun:|1. husband
場合	ばあい	Adverbial noun, Noun:|1. case; situation
一度	いちど	Adverbial noun:|1. once; one time; on one occasion|2. temporarily; for a moment|3. one degree; one tone; one musical interval
運ぶ	はこぶ	Godan verb with bu ending, Transitive verb:|1. to carry; to transport; to move; to convey||Godan verb with bu ending:|2. to come; to go (Honorific or respectful (sonkeigo)) (usu. as お運びになる, お運び下さる, etc.)||Godan verb with bu ending, Transitive verb:|3. to wield (a tool, etc.); to use||Godan verb with bu ending, intransitive verb:|4. to go (well, etc.); to proceed; to progress
今夜	こんや	Adverbial noun, Temporal noun:|1. this evening; tonight
盗む	ぬすむ	Godan verb with mu ending, Transitive verb:|1. to steal
習慣	しゅうかん	Noun, No-adjective:|1. habit|2. custom; cultural practice
たいてい	Na-adjective, Adverb, Noun:|1. mostly; ordinarily; usually; generally (Usually written using kana alone)|2. probably||No-adjective, Noun:|3. most; almost all|4. ordinary (before a neg. form)||Na-adjective:|5. proper; appropriate; moderate (usu. as 〜にする)
残る	のこる	Godan verb with ru ending, intransitive verb:|1. to remain; to be left
上がる	あがる	Godan verb with ru ending, intransitive verb:|1. to rise; to go up; to come up; to ascend; to be raised|2. to enter (esp. from outdoors); to come in; to go in|3. to enter (a school); to advance to the next grade|4. to get out (of water); to come ashore|5. to increase (also written as 騰る in ref. to price)|6. to improve; to make progress|7. to be promoted; to advance|8. to be made (of profit, etc.)|9. to occur (esp. of a favourable result)|10. to be adequate (to cover expenses, etc.) (often as 〜で上がる)|11. to be finished; to be done; to be over|12. (of rain) to stop; to lift|13. to stop (working properly); to cut out; to give out; to die|14. to win (in a card game, etc.)|15. to be arrested|16. to turn up (of evidence, etc.)|17. to be deep fried|18. to be spoken loudly|19. to get stage fright|20. to be offered (to the gods, etc.)|21. to go; to visit (Humble (kenjougo))|22. to eat; to drink (Honorific or respectful (sonkeigo))|23. to be listed (as a candidate) (esp. 挙がる)|24. to serve (in one's master's home)|25. to go north (in Kyoto)||Suffix, Godan verb with ru ending:|26. to be complete; to finish (after the -masu stem of a verb)
席	せき	Noun:|1. seat|2. location (of a gathering, etc.); place|3. position; post
値段	ねだん	Noun:|1. price; cost
将来	しょうらい	Adverbial noun, Temporal noun:|1. future (usually near); prospects
優しい	やさしい	I-adjective:|1. tender; kind; gentle; graceful; affectionate; amiable
いたす	Godan verb with su ending, Transitive verb:|1. to do (Humble (kenjougo), Usually written using kana alone)
空気	くうき	Noun:|1. air; atmosphere|2. mood; situation|3. someone with no presence; someone who doesn't stand out at all (Colloquialism, Idiomatic expression)
逃げる	にげる	Ichidan verb, intransitive verb:|1. to escape; to run away
役に立つ	やくにたつ	Expression, Godan verb with tsu ending:|1. to be helpful; to be useful
答え	こたえ	Noun:|1. answer; reply; response; solution
機会	きかい	Noun:|1. chance; opportunity
予約	よやく	Noun, Suru verb:|1. reservation; appointment; booking; advance order|2. contract; subscription; pledge|3. programming (e.g. a device); setting (e.g. a timer)
原因	げんいん	Noun, Suru verb:|1. cause; origin; source
火事	かじ	Noun:|1. fire; conflagration
泥棒	どろぼう	Noun:|1. thief; burglar; robber||Noun, Suru verb:|2. theft; burglary; robbery
髪	かみ	Noun:|1. hair (on the head)
規則	きそく	Noun:|1. rule; regulation
行う	おこなう	Godan verb with u ending, Transitive verb:|1. to perform; to do; to conduct oneself; to carry out
代わり	かわり	Noun, No-adjective:|1. substitute; replacement; substituting; replacing|2. stand-in; proxy; alternate; deputy; relief; successor|3. compensation; exchange; return (usu. as 〜代わりに, etc.)|4. second helping; another cup; seconds (usu. as お代わり)|5. upcoming program; upcoming programme (Abbreviation) (esp. 替わり, 替り)
見つかる	みつかる	Godan verb with ru ending, intransitive verb:|1. to be found; to be discovered
打つ	うつ	Godan verb with tsu ending, Transitive verb:|1. to hit; to strike; to knock; to beat; to punch; to slap; to tap; to bang; to clap; to pound (also written as 拍つ, 搏つ, 撲つ, 擣つ)|2. to strike (noon, etc.); to sound (cymbals, etc.); to beat (a drum, etc.)|3. to beat (rhythmically, e.g. pulse, waves, etc.)|4. to move; to impress; to touch|5. to drive in; to hammer in; to put in; to inject|6. to type; to send; to transmit|7. to insert; to write in; to mark|8. to make (noodles, etc.); to prepare|9. to till (soil)|10. to sprinkle; to throw; to cast|11. to do; to carry out; to play; to perform; to engage in (gambling, etc.)|12. to pay (a deposit, etc.)|13. to visit (on a pilgrimage)|14. to line (a coat)|15. to bind (a criminal)
厳しい	きびしい	I-adjective:|1. severe; strict; rigid; unsparing; relentless|2. intense (e.g. cold); harsh; tough
増える	ふえる	Ichidan verb, intransitive verb:|1. to increase; to multiply (殖える usu. refers to population growth or capital appreciation)
迎える	むかえる	Ichidan verb, Transitive verb:|1. to go out to meet|2. to receive; to welcome; to greet; to salute; to hail; to reach; to approach; to enter (a phase, era, etc.)|3. to accept (e.g. as a member of a group or family)|4. to call for; to summon; to invite|5. to approach (a certain time, a point in one's life, etc.)
怖い	こわい	I-adjective:|1. scary; frightening; eerie; dreadful
社長	しゃちょう	Noun:|1. company president; manager; director
紹介	しょうかい	Noun, Suru verb, No-adjective:|1. introduction; presentation; referral; listing
集める	あつめる	Ichidan verb, Transitive verb:|1. to collect; to assemble; to gather
事務所	じむしょ	Noun:|1. office
星	ほし	Noun:|1. star; any light-emitting (or reflecting) heavenly body (except for the sun and the moon)|2. offender; perpetrator (Slang) (police slang)|3. star point (in go); hoshi; intersection marked with a dot|4. circular symbol (said to be shaped like a shining star)|5. bullseye|6. one's star (out of the nine stars); the star that determines one's fate|7. small dot; spot|8. point; score (Sumo term)
特に	とくに	Adverb:|1. particularly; especially
集まる	あつまる	Godan verb with ru ending, intransitive verb:|1. to gather; to collect; to assemble
比べる	くらべる	Ichidan verb, Transitive verb:|1. to compare; to make a comparison|2. to compete; to vie
無理	むり	Na-adjective, Noun:|1. unreasonable; unnatural; unjustifiable|2. impossible||Na-adjective, Noun, Suru verb:|3. forcible; forced; compulsory (often as 無理に)||Na-adjective:|4. excessive (work, etc.); immoderate||Suru verb:|5. to work too hard; to try too hard|6. no way; not a chance; never; dream on (Colloquialism)||No-adjective:|7. irrational (Mathematics)
用意	ようい	Noun, Suru verb:|1. preparation; arrangements; provision; getting ready; laying out (e.g. a meal)
落とす	おとす	Godan verb with su ending, Transitive verb:|1. to drop; to lose; to let fall; to shed (light); to cast (one's gaze); to pour in (liquid); to leave behind|2. to clean off (dirt, makeup, paint, etc.); to remove (e.g. stains or facial hair); to lose; to spend money at a certain place; to omit; to leave out; to secretly let escape|3. to lose (a match); to reject (an applicant); to fail (a course); to defeat (in an election)|4. to lower (e.g. shoulders or voice); to lessen (e.g. production or body weight); to worsen (quality); to reduce (e.g. rank or popularity); to speak badly of; to make light of; to fall into straitened circumstances|5. to fall into (e.g. a dilemma or sin); to make one's own; to have one's bid accepted; to force surrender; to take (e.g. an enemy camp or castle); to forcefully convince; to press for a confession; to deal with|6. to download; to copy from a computer to another medium (Computer terminology)|7. to make someone swoon (judo) (Martial arts term)|8. to finish a story (e.g. with the punch line)|9. to finish (a period, e.g. of fasting)
具合	ぐあい	Noun:|1. condition; state|2. health; state (of health)|3. way; manner|4. circumstance; luck|5. face; dignity; decency; propriety
壊れる	こわれる	Ichidan verb, intransitive verb:|1. to be broken; to break|2. to fall through; to come to nothing
倒れる	たおれる	Ichidan verb, intransitive verb:|1. to fall (over, down); to collapse; to take a fall; to topple|2. to be destroyed (in a collapse); to collapse; to cave in; to crumble; to give away|3. to be confined to bed (with an illness); to come down with; to break down (e.g. from overwork)|4. to die; to be killed|5. to go bankrupt (of a company, bank, etc.); to fail; to collapse; to go under|6. to be defeated (in a game); to lose|7. to fall (of a government, dictator, etc.); to be overthrown
味	あじ	Noun:|1. flavor; flavour; taste|2. charm; style|3. experience||Na-adjective:|4. smart; clever; witty; strange
安全	あんぜん	Noun, Na-adjective:|1. safety; security
変	へん	Na-adjective, Noun:|1. strange; odd; peculiar; weird; curious; queer; eccentric; funny; suspicious; fishy|2. unexpected|3. change|4. incident; disturbance; disaster; accident||Noun - used as a prefix:|5. flat (Music term)
祖母	そぼ	Noun, No-adjective:|1. grandmother
連絡	れんらく	Suru verb, No-adjective:|1. to contact; to get in touch||Noun:|2. contacting; getting in touch; communication; call; message|3. connection; coordination; junction||No-adjective:|4. intercalary; intercalaris; internuncial
大事	だいじ	Na-adjective:|1. important; serious; crucial|2. valuable; precious||Noun:|3. serious matter; major incident; matter of grave concern; crisis|4. great undertaking; great enterprise; great thing||Na-adjective:|5. safe; OK (Tochigi dialect)
下がる	さがる	Godan verb with ru ending, intransitive verb:|1. to come down; to go down; to fall; to drop; to sink; to get lower|2. to hang; to dangle|3. to move back; to step back; to withdraw; to retire|4. to deteriorate; to fall off; to be downgraded|5. to get closer to the present day|6. to go south (in Kyoto)
壊す	こわす	Godan verb with su ending, Transitive verb:|1. to break; to destroy; to demolish|2. to wreck; to ruin; to spoil; to damage|3. to break (a bill, etc.)
決まる	きまる	Godan verb with ru ending, intransitive verb:|1. to be decided; to be settled|2. to look good in (clothes)
汽車	きしゃ	Noun:|1. train (esp. long distance train)|2. steam train (orig. meaning)
確か	たしか	Na-adjective, Noun:|1. sure; certain; positive; definite|2. reliable; trustworthy; safe; sound; firm; accurate; correct; exact||Adverb:|3. If I'm not mistaken; If I remember correctly; If I remember rightly
楽しみ	たのしみ	Na-adjective, Noun:|1. enjoyment; pleasure; diversion; amusement; hobby|2. anticipation; looking forward to
おかしい	I-adjective:|1. funny; amusing; comical; laughable; ridiculous (Usually written using kana alone)|2. strange; odd; funny; peculiar; weird; unusual; eccentric (Usually written using kana alone)|3. improper; unsuitable; unbecoming (Usually written using kana alone)|4. suspicious (Usually written using kana alone)
隅	すみ	Noun, Noun - used as a suffix:|1. corner; nook; recess||Noun:|2. downstage right (on a noh stage) (Obscure term)
競争	きょうそう	Noun, Suru verb:|1. competition; contest; rivalry; race|2. competition (between organisms or species) (Biology term)
入院	にゅういん	Noun, Suru verb:|1. hospitalization; hospitalisation
形	かたち	Noun:|1. form; shape; figure|2. visage
景色	けしき	Noun, No-adjective:|1. scenery; scene; landscape
仕方	しかた	Noun:|1. way; method; means; resource; course
留守	るす	Noun, Suru verb, No-adjective:|1. absence; being away from home||Noun, Suru verb:|2. house-sitting; house-sitter||Noun:|3. being left unattended to (of one's studies, etc.); neglecting (usu. as お留守になる)
首	くび	Noun:|1. neck|2. head|3. dismissal; discharge; firing (from a job) (Usually written using kana alone) (also written as 馘)
君	きみ	Pronoun:|1. you; buddy; pal (Male term or language, Familiar language) (also used colloquially by young females)||Noun:|2. monarch; ruler; sovereign; (one's) master (orig. meaning)
血	ち	Noun:|1. blood; consanguinity
以内	いない	Noun, Noun - used as a suffix:|1. within; inside of; less than
例えば	たとえば	Adverb:|1. for example; for instance; e.g.
別れる	わかれる	Ichidan verb, intransitive verb:|1. to part (usu. of people); to part from; to part with; to be apart from|2. to separate (of a couple); to break up; to divorce|3. to lose (e.g. one's mother); to be bereaved
棚	たな	Noun:|1. shelf; shelves; ledge; rack|2. trellis
複雑	ふくざつ	Na-adjective:|1. complex; complicated; mixed (feelings)
引っ越す	ひっこす	Godan verb with su ending, intransitive verb:|1. to move (house); to change residence
申し上げる	もうしあげる	Ichidan verb, Transitive verb:|1. to say; to tell; to state; to express; to offer; to extend (greetings, congratulations, etc.) (Humble (kenjougo))||Auxiliary verb:|2. to do (Humble (kenjougo))
品物	しなもの	Noun:|1. goods; article; thing
技術	ぎじゅつ	Noun:|1. technology; engineering|2. technique; skill|3. art; craft
ご存じ	ごぞんじ	Noun:|1. knowing (Honorific or respectful (sonkeigo))|2. (an) acquaintance
草	くさ	Noun:|1. grass; weed; herb; thatch|2. ninja (Archaism)||Prefix:|3. not genuine; substandard||Expression:|4. laughter; LOL (Slang)
以下	いか	Noun:|1. not exceeding; and downward; ... and below|2. below (e.g. standard); under (e.g. a level)|3. the below-mentioned; the following; the rest
倍	ばい	Noun:|1. twice; double||Suffix:|2. times; -fold
両方	りょうほう	Noun, No-adjective:|1. both; both sides; both parties
港	みなと	Noun:|1. harbour; harbor; port
安心	あんしん	Na-adjective, Noun, Suru verb:|1. relief; peace of mind
だいたい	Noun:|1. outline; main point; gist (Usually written using kana alone)||Adverbial noun, Temporal noun:|2. general; substantially; approximately; about (Usually written using kana alone)|3. in the first place; to begin with; from the start (Usually written using kana alone)
線	せん	Noun, Noun - used as a suffix:|1. line; stripe; stria|2. line (e.g. telephone line); wire|3. ray (e.g. X-ray); beam|4. line (e.g. of a railroad); track; route; lane|5. outline; contours; form|6. level|7. division|8. line (of action); position; approach; policy; principle|9. impression one leaves; air one gives off
下げる	さげる	Ichidan verb, Transitive verb:|1. to hang; to suspend; to wear (e.g. decoration)|2. to lower; to reduce; to bring down|3. to demote; to move back; to pull back|4. to clear (plates); to remove (food, etc. from table or altar)
虫	むし	Noun:|1. insect; bug; cricket; moth; worm
小鳥	ことり	Noun:|1. small bird; little bird
高校生	こうこうせい	Noun:|1. senior high school student
乗り換える	のりかえる	Ichidan verb, Transitive verb:|1. to transfer (trains); to change (bus, train)|2. to change one's mind; to move on to (e.g. a new love interest); to change methods; to change one's way of thinking
枝	えだ	Noun:|1. branch; bow; bough; twig; limb
寺	てら	Noun:|1. temple (Buddhist)
着物	きもの	Noun:|1. clothing; clothes|2. kimono (or other trad. Japanese clothing)
終わり	おわり	Noun:|1. the end
店員	てんいん	Noun, No-adjective:|1. shop assistant; employee; clerk; salesperson
帰り	かえり	Noun:|1. return; coming back
通う	かよう	Godan verb with u ending, intransitive verb:|1. to go to and from (a place); to go back and forth between; to run between (e.g. bus, train, etc.); to ply between|2. to go to (school, work, etc.); to attend; to commute; to frequent|3. to circulate (e.g. blood, electricity); to be communicated (e.g. thought)|4. to resemble
騒ぐ	さわぐ	Godan verb with gu ending, intransitive verb:|1. to make noise; to make racket; to be noisy|2. to rustle; to swoosh|3. to make merry|4. to clamor; to clamour; to make a fuss; to kick up a fuss|5. to lose one's cool; to panic; to act flustered|6. to feel tense; to be uneasy; to be excited
柔らかい	やわらかい	I-adjective:|1. soft; tender; pliant; supple; limber; limp|2. gentle; mild; mellow|3. informal; light; flexible (e.g. thinking)
丁寧	ていねい	Na-adjective, Noun:|1. polite; courteous; civil|2. careful; close; thorough; conscientious
踏む	ふむ	Godan verb with mu ending, Transitive verb:|1. to step on; to tread on; to trample on|2. to set foot on (e.g. foreign soil); to stand on; to visit|3. to experience; to undergo|4. to follow (rules, principles, etc.); to go through (e.g. formalities); to complete|5. to estimate; to guess; to judge; to value; to appraise|6. to rhyme|7. to succeed to (e.g. the throne)
裏	うら	Noun:|1. opposite side; bottom; other side; side hidden from view; undersurface; reverse side|2. rear; back; behind|3. lining; inside|4. in the shadows; behind the scenes; offstage; behind one's back|5. more (to something than meets the eye); hidden side (e.g. of one's personality); unknown circumstances; different side|6. proof|7. opposite (of a prediction, common sense, etc.); contrary|8. inverse (of a hypothesis, etc.)|9. bottom (of an inning); last half (of an inning) (Baseball term)
冷える	ひえる	Ichidan verb, intransitive verb:|1. to grow cold (from room temperature, e.g. in refrigerator); to get chilly; to cool down
真ん中	まんなか	Noun:|1. middle; centre; center; mid-way
遠慮	えんりょ	Noun, Suru verb:|1. reserve; constraint; restraint; modesty; diffidence; hesitation; holding back; discretion; tact; thoughtfulness|2. declining; refraining|3. forethought; foresight (orig. meaning)
飾る	かざる	Godan verb with ru ending, Transitive verb:|1. to decorate; to ornament; to adorn
表	おもて	Noun:|1. surface|2. face (i.e. the visible side of an object)|3. front (of a building, etc.); obverse side (i.e. "head") of a coin|4. outside; exterior|5. appearance|6. public|7. first half (of an inning); top (of an inning) (Baseball term)|8. cover (for tatami mats, etc.)|9. foreground (Computer terminology)
都合	つごう	Adverb, Noun:|1. circumstances; condition; convenience||Suru verb:|2. to arrange; to manage|3. to lend money; to raise money||Adverb:|4. in all; in total; all told
暮れる	くれる	Ichidan verb, intransitive verb:|1. to get dark; to grow dark|2. to end (of a day, year, season, etc.); to come to an end; to close|3. to be sunk in (e.g. despair); to be lost in (e.g. thought); to be overcome with
部長	ぶちょう	Noun:|1. head (chief, director) of a section or department|2. head of a (school) club; head of a (school) team
昼間	ひるま	Adverbial noun, Temporal noun:|1. daytime; during the day; time from sunrise until sunset; diurnal period
引き出し	ひきだし	Noun:|1. drawer|2. withdrawal (of money from an account) (not 抽斗,抽匣)|3. variety of knowledge and experience useful for handling things impromptu (not 抽斗,抽匣)
急	きゅう	Na-adjective:|1. sudden; abrupt; unexpected|2. urgent; pressing|3. steep; sharp; precipitous|4. rapid; swift; fast||Noun:|5. emergency; crisis; danger|6. urgency; hurrying; haste|7. (in gagaku or noh) end of a song
会場	かいじょう	Noun:|1. assembly hall; meeting place; venue; grounds
または	Conjunction, Expression:|1. or; otherwise (Usually written using kana alone)
地理	ちり	Noun:|1. geography
電灯	でんとう	Noun:|1. electric light
急行	きゅうこう	Noun, Suru verb, No-adjective:|1. hurrying (to somewhere); rushing; hastening||Noun:|2. express (train) (Abbreviation)
踊り	おどり	Noun:|1. dance
適当	てきとう	Na-adjective, Noun:|1. suitable; proper; appropriate; adequate; fit|2. noncommittal; vague; equivocal; unserious; irresponsible
細かい	こまかい	I-adjective:|1. small|2. fine; minute|3. minor; trivial|4. sensitive; attentive
課長	かちょう	Noun:|1. section manager; section chief
盛ん	さかん	Na-adjective:|1. popular|2. prosperous|3. enthusiastic|4. energetic; vigorous (also written as 壮)
暖房	だんぼう	Noun, Suru verb:|1. (indoor) heating
割合	わりあい	Adverb, Noun:|1. rate; ratio; percentage; proportion|2. comparatively|3. contrary to expectations
引き出す	ひきだす	Godan verb with su ending, Transitive verb:|1. to pull out; to take out; to draw out; to withdraw
申す	もうす	Godan verb with su ending, Transitive verb:|1. to say; to be called (Humble (kenjougo))|2. to do (Humble (kenjougo)) (after a word beginning with お- or ご-)
退院	たいいん	Noun, Suru verb:|1. leaving hospital; discharge from hospital
売り場	うりば	Noun:|1. selling area; counter; section; department; sales floor|2. favorable time to sell; good time to sell
講堂	こうどう	Noun:|1. auditorium; lecture hall
下宿	げしゅく	Noun, Suru verb:|1. boarding; lodging; boarding house
受付	うけつけ	Noun:|1. reception (desk); information desk (esp. 受付)||Noun, Suru verb:|2. receipt; acceptance
不便	ふべん	Na-adjective, Noun:|1. inconvenience; inexpediency; unhandiness
食料品	しょくりょうひん	Noun:|1. foodstuff; groceries
新聞社	しんぶんしゃ	Noun:|1. newspaper company
苦い	にがい	I-adjective:|1. bitter
湯	ゆ	Noun:|1. hot water|2. hot bath; hot spring|3. molten iron
写す	うつす	Godan verb with su ending, Transitive verb:|1. to transcribe; to duplicate; to reproduce; to imitate; to trace|2. to describe|3. to film; to picture; to photograph
工業	こうぎょう	Noun:|1. (manufacturing) industry
工業	こうぎょう	Noun:|1. (manufacturing) industry
冷房	れいぼう	Noun, Suru verb:|1. cooling; air-conditioning
下着	したぎ	Noun:|1. underwear
畳	たたみ	Noun:|1. tatami mat; Japanese straw floor coverings
お嬢さん	おじょうさん	Noun:|1. (another's) daughter (Polite (teineigo))|2. young lady
沸かす	わかす	Godan verb with su ending, Transitive verb:|1. to boil; to heat|2. to excite|3. to melt (metal) (Archaism)
漬ける	つける	Ichidan verb, Transitive verb:|1. to soak; to seep; to dip in|2. to pickle
特急	とっきゅう	Noun:|1. limited express (train, faster than an express) (Abbreviation)|2. great hurry
くれる	Ichidan verb (kureru special class), Transitive verb, Auxiliary verb:|1. to give; to let one have; to do for one; to be given (Usually written using kana alone) (くれ is an irregular alternative imperative form)
過ぎる	すぎる	Ichidan verb, intransitive verb:|1. to pass through; to pass by; to go beyond|2. to pass (i.e. of time); to elapse|3. to have expired; to have ended; to be over|4. to exceed; to surpass; to be above|5. to be no more than ... (as 〜に過ぎない, etc.)||Ichidan verb, intransitive verb, Suffix:|6. to be excessive; to be too much; to be too ... (Usually written using kana alone) (often used after adjective stems or the -masu stems of verbs)
つもり	Noun:|1. intention; plan (Usually written using kana alone)|2. conviction; belief (Usually written using kana alone)
ほとんど	Adverbial noun, Temporal noun:|1. mostly; nearly; practically; well-nigh; almost invariably; all but; just about; almost (Usually written using kana alone)
止める	とめる	Ichidan verb, Transitive verb:|1. to stop; to turn off (esp. 止める, 停める)|2. to park (esp. 止める, 停める)|3. to prevent; to suppress (a cough); to hold back (tears); to hold (one's breath); to relieve (pain) (esp. 止める, 停める)|4. to stop (someone from doing something); to dissuade; to forbid; to prohibit|5. to notice; to be aware of; to concentrate on; to pay attention to; to remember; to bear in mind|6. to fix (in place); to fasten; to tack; to pin; to nail; to button; to staple (esp. 留める)|7. to detain; to keep in custody (esp. 留める)
ひどい	I-adjective:|1. cruel; heartless; hard; harsh; severe (Usually written using kana alone)|2. violent; intense; strong; heavy; extreme (Usually written using kana alone)|3. very bad; terrible; awful (Usually written using kana alone)|4. excessive; exorbitant; unreasonable; outrageous; unfair; unjust (Usually written using kana alone)
遅れる	おくれる	Ichidan verb, intransitive verb:|1. to be late; to be delayed; to fall behind schedule; to be overdue
続ける	つづける	Ichidan verb, Transitive verb, Auxiliary verb:|1. to continue; to keep up; to keep on
手伝う	てつだう	Godan verb with u ending, Transitive verb:|1. to help; to assist; to aid|2. to contribute to; to be a factor in
見つける	みつける	Ichidan verb, Transitive verb:|1. to discover; to find (e.g. an error in a book); to come across; to detect; to spot|2. to locate; to find (e.g. something missing); to find fault|3. to be used to seeing; to be familiar with
驚く	おどろく	Godan verb with ku ending, intransitive verb:|1. to be surprised; to be astonished
開く	ひらく	Godan verb with ku ending, intransitive verb, Transitive verb:|1. to open; to undo; to unseal; to unpack|2. to bloom; to unfold; to spread out|3. to open (for business, e.g. in the morning)|4. to be wide (gap, etc.); to widen||Godan verb with ku ending, Transitive verb:|5. to hold (meeting, etc.); to give; to open|6. to found (nation, dynasty, sect, etc.); to open (a new business); to set up; to establish; to start|7. to open (ports, borders, etc.)|8. to open (an account)|9. to open up (new land, path, etc.); to clear; to develop|10. to open (a file, etc.) (Computer terminology)|11. to extract (root); to reduce (equation) (Mathematics)|12. to cut open (fish) (Food term) (as 魚を開く)|13. to change (kanji into hiragana)||Godan verb with ku ending, intransitive verb:|14. to flare (e.g. skirt)|15. to slacken (into a poor posture) (Sports term) (as 体が開く, 肩が開く, etc.)
眠る	ねむる	Godan verb with ru ending, intransitive verb:|1. to sleep (not necessarily lying down)|2. to die|3. to lie idle (e.g. of resources); to be dormant; to be unused|4. to close one's eyes (Archaism)
勝つ	かつ	Godan verb with tsu ending, intransitive verb:|1. to win; to gain victory
聞こえる	きこえる	Ichidan verb, intransitive verb:|1. to be heard; to be audible|2. to be said to be; to be reputed
尋ねる	たずねる	Ichidan verb, Transitive verb:|1. to ask; to enquire; to inquire|2. to search; to look for; to look into; to investigate
慣れる	なれる	Ichidan verb, intransitive verb:|1. to get used to; to grow accustomed to; to become familiar with (esp. 慣れる)|2. to become skilled in; to become experienced at (esp. 慣れる)|3. to become tame; to become domesticated (esp. 馴れる)||Ichidan verb, Auxiliary verb:|4. to get used to doing (after the -masu stem of a verb)
泣く	なく	Godan verb with ku ending:|1. to cry; to weep; to sob; to howl
似る	にる	Ichidan verb, intransitive verb:|1. to resemble; to look like; to take after|2. to be similar (in status, condition, etc.); to be close; to be alike; to be like
きっと	Adverb:|1. surely; undoubtedly; almost certainly; most likely (e.g. 90 percent) (Usually written using kana alone, Onomatopoeic or mimetic word)|2. sternly; severely (Usually written using kana alone, Onomatopoeic or mimetic word) (esp. キッと)|3. having no slack; rigid; stiff; tight (Usually written using kana alone, Onomatopoeic or mimetic word)|4. suddenly; abruptly; instantly (Usually written using kana alone, Onomatopoeic or mimetic word, Archaism)
戻る	もどる	Godan verb with ru ending, intransitive verb:|1. to turn back (e.g. half-way)|2. to return; to go back|3. to recover (e.g. something lost); to be returned|4. to rebound; to spring back
調べる	しらべる	Ichidan verb, Transitive verb:|1. to examine; to look up; to investigate; to check up; to sense; to study; to inquire; to search
伝える	つたえる	Ichidan verb, Transitive verb:|1. to convey; to report; to transmit; to communicate; to tell; to impart; to propagate; to teach; to bequeath
はず	Noun:|1. expectation that something took place, will take place or was in some state; it should be so; bound to be; expected to be; must be (Usually written using kana alone)|2. nock (of a bow)|3. nock (of an arrow)|4. nock-shaped grip (between thumb and forefinger) (Sumo term)|5. wooden frame on the tip of the mast of a Japanese ship that prevents the hawser from falling out
なくなる	Godan verb with ru ending, intransitive verb:|1. to be lost (e.g. luggage); to be missing (Usually written using kana alone)|2. to be used up; to be run out; to be exhausted; to be consumed; to be reduced to zero; to not occur any more (Usually written using kana alone)|3. to disappear (e.g. pain); to be lost (e.g. a dream, confidence) (Usually written using kana alone)
動く	うごく	Godan verb with ku ending, intransitive verb:|1. to move; to stir; to shift; to shake; to swing|2. to operate; to run; to go; to work|3. to be touched; to be influenced|4. to change; to vary; to fluctuate; to waver|5. certain; factual (as 動かぬ, 動かない, etc.)|6. to be transferred
知らせる	しらせる	Ichidan verb, Transitive verb:|1. to notify; to advise; to inform
続く	つづく	Godan verb with ku ending, intransitive verb:|1. to continue; to last; to go on|2. to continue (without a break); to be unbroken|3. to occur again and again|4. to lead to; to connect to; to adjoin|5. to come after; to follow; to succeed; to rank next to|6. to hold out; to keep; to last
別	べつ	Noun:|1. distinction; difference; discrimination||No-adjective, Na-adjective, Noun:|2. separate; different; another; extra||Noun:|3. exception; exclusion (oft. as 別として)||Noun - used as a suffix:|4. classified by; ranked by; according to
鳴る	なる	Godan verb with ru ending, intransitive verb:|1. to sound; to ring; to resound; to echo; to roar; to rumble
市	し	Noun, Noun - used as a suffix:|1. city
負ける	まける	Ichidan verb, intransitive verb:|1. to lose; to be defeated|2. to succumb; to give in; to surrender; to yield|3. to be inferior to|4. to break out in a rash due to (e.g. lacquer, shaving, etc.)||Ichidan verb, Transitive verb:|5. to reduce the price; to give a discount; to throw in (something extra) for free
悲しい	かなしい	I-adjective:|1. sad; sorrowful
亡くなる	なくなる	Godan verb with ru ending, intransitive verb:|1. to die
以外	いがい	Adverbial noun:|1. with the exception of; excepting
治す	なおす	Godan verb with su ending, Transitive verb:|1. to cure; to heal (usu. 治す)|2. to fix; to correct; to repair (usu. 直す)||Auxiliary verb:|3. to do over again (after -masu base of verb; usu. 直す)|4. to replace; to put back as it was (Kansai dialect) (usu. 直す)|5. to convert (into a different state); to transform (usu. 直す)
しばらく	Adverb, Suru verb:|1. for a moment; for a minute (Usually written using kana alone)||Adverb:|2. for a while; for some time (Usually written using kana alone)|3. for the time being; for now (Usually written using kana alone)|4. it's been a long time; long time no see (Usually written using kana alone)
回る	まわる	Godan verb with ru ending, intransitive verb:|1. to turn; to revolve|2. to visit several places|3. to function well|4. to pass a certain time
間違える	まちがえる	Ichidan verb, Transitive verb:|1. to make a mistake (in); to commit an error (e.g. in calculation)|2. to confuse; to mistake something for something else
捨てる	すてる	Ichidan verb, Transitive verb:|1. to throw away; to cast away; to dump; to discard|2. to abandon; to desert; to leave|3. to give up; to resign
しっかり	Adverb, Adverb taking the 'to' particle, Suru verb:|1. tightly (holding on); firmly; securely (Usually written using kana alone, Onomatopoeic or mimetic word)|2. strongly (built); solidly; sturdily; steadily (Usually written using kana alone, Onomatopoeic or mimetic word)|3. properly; well; sufficiently; hard (working, etc.); fully; completely (Usually written using kana alone, Onomatopoeic or mimetic word)|4. reliably; dependably; levelheadedly; shrewdly; wisely; cleverly (Usually written using kana alone, Onomatopoeic or mimetic word)
育てる	そだてる	Ichidan verb, Transitive verb:|1. to raise; to rear; to bring up|2. to train; to teach; to educate|3. to promote the growth of; to nurture; to foster; to develop
褒める	ほめる	Ichidan verb, Transitive verb:|1. to praise; to admire; to speak well of someone
石	いし	Noun:|1. stone|2. gem; jewel
恥ずかしい	はずかしい	I-adjective:|1. embarrassing; embarrassed; ashamed; humiliated; shy|2. disgraceful; shameful
塗る	ぬる	Godan verb with ru ending, Transitive verb:|1. to paint; to plaster; to lacquer; to varnish; to spread; to smear; to put up (wallpaper)
泊まる	とまる	Godan verb with ru ending, intransitive verb:|1. to stay at (e.g. hotel)|2. to be docked; to be berthed; to be moored
片付ける	かたづける	Ichidan verb, Transitive verb:|1. to tidy up; to put in order; to straighten up; to put away|2. to settle (problem); to clear (dispute)|3. to finish; to bring something to an end|4. to marry off (e.g. a daughter) (sometimes 嫁ける)|5. to do away with someone; to bump someone off
止む	やむ	Godan verb with mu ending, intransitive verb:|1. to cease; to stop; to be over
遠く	とおく	No-adjective, Adverbial noun, Noun:|1. far away; distant; at a distance; distant place; by far
済む	すむ	Godan verb with mu ending, intransitive verb:|1. to finish; to end; to be completed|2. to merely result in something less severe than expected|3. to feel at ease|4. to feel unease or guilt for troubling someone; to be sorry (in the negative)
とうとう	Adverb:|1. finally; at last; ultimately; in the end (Usually written using kana alone)
捕まえる	つかまえる	Ichidan verb, Transitive verb:|1. to catch; to arrest; to seize
踊る	おどる	Godan verb with ru ending, intransitive verb:|1. to dance (orig. a hopping dance)
足りる	たりる	Ichidan verb, intransitive verb:|1. to be sufficient; to be enough|2. to be worth doing; to be worthy of; to deserve (in the form に足りる after a verb)|3. to do (the job); to serve; to answer
治る	なおる	Godan verb with ru ending, intransitive verb:|1. to be cured; to get well; to be healed (esp. 治る)|2. to get mended; to be repaired; to be fixed (esp. 直る)
なさる	Godan verb - aru special class, Transitive verb:|1. to do (Honorific or respectful (sonkeigo), Usually written using kana alone)
硬い	かたい	I-adjective:|1. hard; solid; tough (esp. 固い and 堅い for wood, 硬い for metal and stone)|2. stiff; tight; wooden; unpolished (e.g. writing)|3. strong; firm (not viscous or easily moved)|4. safe; steady; honest; steadfast|5. obstinate; stubborn|6. bookish; formal; stuffy
建てる	たてる	Ichidan verb, Transitive verb:|1. to build; to construct
すごい	I-adjective:|1. terrible; dreadful (Usually written using kana alone)|2. amazing (e.g. of strength); great (e.g. of skills); wonderful; terrific (Usually written using kana alone)|3. to a great extent; vast (in numbers) (Usually written using kana alone)
謝る	あやまる	Godan verb with ru ending:|1. to apologize; to apologise
これから	Temporal noun:|1. after this (Usually written using kana alone)
立てる	たてる	Ichidan verb, Transitive verb:|1. to stand up; to put up; to set up; to erect; to raise (also written as 起てる)|2. to thrust into; to bury into; to dig into|3. to make (a noise); to start (a rumour); to raise (a cloud of dust, etc.); to cause|4. to make; to establish; to set up; to develop; to formulate|5. to put up (a political candidate); to make (one's leader)|6. to treat with respect; to give (someone) their due; to make (someone) look good; to avoid embarrassing (someone)|7. to sharpen; to make clear|8. to shut; to close|9. to make tea (matcha); to perform the tea ceremony|10. to divide by||Suffix, Ichidan verb:|11. to do ... vigorously (after the -masu stem of a verb)
寂しい	さびしい	I-adjective:|1. lonely; lonesome; solitary; desolate
濡れる	ぬれる	Ichidan verb, intransitive verb:|1. to get wet
投げる	なげる	Ichidan verb, Transitive verb:|1. to throw; to hurl; to fling; to toss; to cast|2. to give up; to abandon; to throw away|3. to cast (a glance, shadow, doubt, etc.)
太る	ふとる	Godan verb with ru ending, intransitive verb:|1. to grow fat (stout, plump); to become fat; to gain weight
寄る	よる	Godan verb with ru ending, intransitive verb:|1. to approach; to draw near; to come near; to be close to|2. to gather (in one place); to come together; to meet|3. to stop by (while on one's way to another place); to drop by; to make a short visit|4. to grow old; to grow high (number, etc.)|5. to grow (wrinkly) (in the form of しわが寄る)|6. to lean against; to recline on (also written as 倚る, 凭る)|7. to push one's opponent while holding their belt (Sumo term)|8. to decide on a price and come to a deal|9. to be swayed by (a person); to yield to (Archaism)
歯医者	はいしゃ	Noun:|1. dentist
まいる	Godan verb with ru ending, intransitive verb:|1. to go; to come; to call (Humble (kenjougo), Usually written using kana alone)|2. to be defeated; to collapse; to die|3. to be annoyed; to be nonplussed|4. to be madly in love|5. to visit (shrine, grave)
召し上がる	めしあがる	Godan verb with ru ending, Transitive verb:|1. to eat; to drink (Honorific or respectful (sonkeigo))
珍しい	めずらしい	I-adjective:|1. unusual; rare; curious|2. new; novel|3. fine (e.g. gift)
揺れる	ゆれる	Ichidan verb, intransitive verb:|1. to shake; to sway; to waver
祈る	いのる	Godan verb with ru ending, Transitive verb:|1. to pray; to wish
ガラス	Noun:|1. glass; pane (Usually written using kana alone)||Noun or verb acting prenominally:|2. vitreous
込む	こむ	Godan verb with mu ending, intransitive verb:|1. to be crowded; to be packed|2. to be complex||Auxiliary verb:|3. to go into; to put into; to remain (seated); to be plunged into (silence); to do thoroughly|4. to do intently|5. to continue in the same state
折る	おる	Godan verb with ru ending, Transitive verb:|1. to break; to fracture; to break off; to snap off; to pick (e.g. flowers)|2. to fold; to bend|3. to make (origami)|4. to interrupt; to end
大学生	だいがくせい	Noun:|1. university student; college student
お礼	おれい	Noun:|1. thanks; gratitude (Polite (teineigo))|2. manners; etiquette (Polite (teineigo))|3. bow (Polite (teineigo))|4. reward; gift (Polite (teineigo))|5. ceremony; ritual (Polite (teineigo))
眠い	ねむい	I-adjective:|1. sleepy; drowsy; somnolent
それほど	Adverb:|1. to that degree; to that extent; that much (Usually written using kana alone)
痩せる	やせる	Ichidan verb, intransitive verb:|1. to become thin; to lose weight; to reduce (one's) weight; to slim|2. to be barren; to be infertile; to be sterile
たまに	Adverb, Suffix:|1. occasionally; once in a while (Usually written using kana alone)
噛む	かむ	Godan verb with mu ending, Transitive verb:|1. to bite; to chew; to gnaw|2. to crash against (e.g. of waves); to break onto (shore)|3. to engage (of cogs, zippers, etc.); to mesh; to fit together|4. to be involved in|5. to fumble one's words (during a play, broadcast, etc.); to falter with one's words|6. to strongly confute; to argue down; to rebuke; to scold harshly (Archaism)
億	おく	Numeric:|1. 10^8; 100,000,000; hundred million
ガス	Noun:|1. gas (state of matter, e.g. poison gas, natural gas) (Usually written using kana alone)|2. gasoline; gas; petrol (Usually written using kana alone)|3. dense fog; thick fog (Usually written using kana alone)|4. gas stove; gas cooker; gas range (Usually written using kana alone, Abbreviation)|5. flatulence; gas; wind; fart (Usually written using kana alone, Colloquialism)
触る	さわる	Godan verb with ru ending, intransitive verb:|1. to touch; to feel (often now with を)
すり	Noun:|1. pickpocket (Usually written using kana alone)
なるほど	Expression, Adverb:|1. I see; that's right; indeed (Usually written using kana alone)
拾う	ひろう	Godan verb with u ending, Transitive verb:|1. to pick up; to find; to gather
焼く	やく	Godan verb with ku ending, Transitive verb:|1. to burn|2. to roast; to broil; to grill; to bake; to toast; to barbecue|3. to heat; to heat up|4. to make (charcoal, pottery, bricks, etc.); to bake; to fire; to burn|5. to tan (i.e. suntan); to burn|6. to print (a photo); to burn (an optical disc)|7. to be jealous of; to be envious of; to envy
滑る	すべる	Godan verb with ru ending, intransitive verb:|1. to glide; to slide (e.g. on skis); to slip|2. to fail (an examination); to bomb (when telling a joke)|3. to drop; to go down; to come down; to fall (e.g. in status)
滑る	すべる	Godan verb with ru ending, intransitive verb:|1. to glide; to slide (e.g. on skis); to slip|2. to fail (an examination); to bomb (when telling a joke)|3. to drop; to go down; to come down; to fall (e.g. in status)
ちっとも	Adverb:|1. not at all (neg. verb) (Usually written using kana alone)
お宅	おたく	Noun:|1. your house; your home; your family (Honorific or respectful (sonkeigo))|2. your husband (Honorific or respectful (sonkeigo))|3. your organization (Honorific or respectful (sonkeigo))||Pronoun:|4. you (Honorific or respectful (sonkeigo)) (referring to someone of equal status with whom one is not especially close)
折れる	おれる	Ichidan verb, intransitive verb:|1. to break; to be broken; to snap; to fracture|2. to be folded|3. to give in; to back down; to yield; to submit|4. to turn (a corner)
移る	うつる	Godan verb with ru ending, intransitive verb:|1. to move (house); to transfer (department)|2. to change the target of interest or concern|3. to elapse (passage of time)|4. to be permeated by a colour or scent|5. to be infected; to be contagious; to spread (as in fire) (Usually written using kana alone)
光る	ひかる	Godan verb with ru ending, intransitive verb:|1. to shine; to glitter; to be bright
植える	うえる	Ichidan verb, Transitive verb:|1. to plant; to grow; to raise|2. to insert; to transplant; to implant; to set (type)|3. to inoculate (e.g. an infectious agent)|4. to instill (idea, value, etc.); to instil; to inculcate
差し上げる	さしあげる	Auxiliary verb, Ichidan verb, Transitive verb:|1. to give; to offer (Humble (kenjougo))||Ichidan verb, Transitive verb:|2. to lift up; to hold up; to raise (Humble (kenjougo))
字	じ	Noun:|1. character (i.e. kanji)|2. hand-writing; penmanship|3. the ... word (i.e. "the L word" = "love") (as 〜の字)
焼ける	やける	Ichidan verb, intransitive verb:|1. to burn; to be roasted; to be heated; to be sunburnt; to fade (in the sun); to glow red (i.e. of the sky at sunset)|2. to be jealous; to be envious
お祝い	おいわい	Noun, Suru verb:|1. congratulation; congratulations; celebration; festival; congratulatory gift (Honorific or respectful (sonkeigo))
取り替える	とりかえる	Ichidan verb, Transitive verb:|1. to exchange; to replace
釣る	つる	Godan verb with ru ending, Transitive verb:|1. to fish; to angle; to catch|2. to lure in; to tempt; to attract; to entice; to allure
乾く	かわく	Godan verb with ku ending, intransitive verb:|1. to get dry
用事	ようじ	Noun:|1. tasks; things to do; errand; business (to take care of); affairs; engagement
なるべく	Adverb:|1. as much as possible; wherever practicable; if possible (Usually written using kana alone)
浅い	あさい	I-adjective:|1. shallow; superficial|2. slight (wound); light (sleep); pale (colour); inadequate (knowledge)|3. short (time); early; young
届ける	とどける	Ichidan verb, Transitive verb:|1. to deliver; to forward; to send|2. to report; to notify; to file notice (to the authorities); to give notice; to register
いじめる	Ichidan verb, Transitive verb:|1. to ill-treat; to bully; to torment; to pick on; to tease; to be cruel to; to persecute (Usually written using kana alone)|2. to be tough on (e.g. one's body); to treat harshly (Usually written using kana alone)
お土産	おみやげ	Noun:|1. present; souvenir (Polite (teineigo))
床屋	とこや	Noun:|1. barbershop; barber
拝見	はいけん	Noun, Suru verb:|1. seeing; looking at (Humble (kenjougo), Polite (teineigo))
足す	たす	Godan verb with su ending, Transitive verb:|1. to add (numbers)|2. to add (something); to top up (with something)|3. to take care of (e.g. one's business)
お釣り	おつり	Noun:|1. change (for a purchase) (Polite (teineigo))
予習	よしゅう	Noun, Suru verb:|1. preparation for a lesson
寝坊	ねぼう	Noun, Suru verb, Na-adjective, No-adjective:|1. sleeping in late; oversleeping||Noun:|2. late riser; sleepyhead
忘れ物	わすれもの	Noun:|1. lost article; something forgotten
沸く	わく	Godan verb with ku ending, intransitive verb:|1. to grow hot (e.g. water); to boil|2. to get excited (at); to erupt (in applause, cheering, etc.); to be in a ferment; to take place energetically|3. to ferment|4. to melt (of metal)
復習	ふくしゅう	Noun, Suru verb:|1. review; revision
ご主人	ごしゅじん	Noun:|1. your husband; her husband (Honorific or respectful (sonkeigo))
再来月	さらいげつ	Adverbial noun, Temporal noun:|1. month after next
再来週	さらいしゅう	Adverbial noun, Temporal noun:|1. week after next
付く	つく	Godan verb with ku ending, intransitive verb:|1. to be attached; to be connected with; to adhere; to stick; to cling|2. to remain imprinted; to scar; to stain; to dye|3. to bear (fruit, interest, etc.)|4. to be acquired (of a habit, ability, etc.); to increase (of strength, etc.)|5. to take root|6. to accompany; to attend; to follow; to study with|7. to side with; to belong to|8. to possess; to haunt|9. to be lit; to be lighted|10. to be settled; to be resolved; to be decided|11. to be given (of a name, price, etc.)|12. to be sensed; to be perceived|13. to be lucky (from 運がつく)||Suffix, Godan verb with ku ending:|14. to become (a state, condition, etc.) (after -masu stems, onomatopoeic and mimetic words)
変える	かえる	Ichidan verb, Transitive verb:|1. to change; to alter; to transform; to convert; to turn; to vary|2. to reform; to revise; to amend
アフリカ	Noun, No-adjective:|1. Africa (Usually written using kana alone)
看護師	かんごし	Noun:|1. (hospital) nurse; registered nurse; RN
降り出す	ふりだす	Godan verb with su ending, intransitive verb:|1. to begin to rain; to begin to snow
けど	Conjunction, Particle:|1. but; however; although
日	ひ	Adverbial noun, Temporal noun:|1. day; days|2. sun; sunshine; sunlight|3. case (esp. unfortunate); event (as 〜した日には, 〜と来た日には, etc.)||Wikipedia definition:|4. Day
だいぶ	Adverb:|1. considerably; greatly; a lot (Usually written using kana alone)||Wikipedia definition:|2. Oita
間	あいだ	Adverbial noun, Noun:|1. space (between); gap; interval; distance||Adverbial noun, Temporal noun:|2. time (between); pause; break||Adverbial noun, Noun, Temporal noun:|3. span (temporal or spatial); stretch; period (while)||Adverbial noun, Noun:|4. relationship (between, among)|5. members (within, among)||Conjunction:|6. due to; because of (Archaism)||Wikipedia definition:|7. Ma (negative space)
親	おや	Noun:|1. parent; parents; mother and father|2. dealer (in cards, mahjong, etc.); banker|3. founder; inventor|4. (pet) owner||No-adjective, Noun:|5. key; parent (organization); main||Noun:|6. ancestor; forefather||Wikipedia definition:|7. Parent
熱	ねつ	Noun:|1. heat|2. fever; temperature|3. zeal; passion; enthusiasm|4. mania; craze; rage||Wikipedia definition:|5. Heat
運転手	うんてんしゅ	Noun:|1. driver; chauffeur||Wikipedia definition:|2. Chauffeur
木綿	もめん	Noun:|1. cotton (material)|2. red silk-cotton tree (Bombax ceiba) (Usually written using kana alone)||Wikipedia definition:|3. Cotton
消しゴム	けしゴム	Noun:|1. eraser; India rubber||Wikipedia definition:|2. Eraser
テニス	Noun:|1. tennis||Wikipedia definition:|2. Tennis
ピアノ	Noun:|1. piano (Music term)||Wikipedia definition:|2. Piano
コンピュータ	Noun:|1. computer||Wikipedia definition:|2. Computer
周り	まわり	Noun:|1. circumference; girth|2. surroundings; neighbourhood; neighborhood; vicinity
ケーキ	Noun:|1. cake||Wikipedia definition:|2. Cake
ビル	Noun:|1. multi-floor building; multi-storey building (Abbreviation)|2. bill||Wikipedia definition:|3. Bill
カーテン	Noun:|1. curtain; curtains||Wikipedia definition:|2. Curtain
ガソリン	Noun:|1. gasoline; petrol||Wikipedia definition:|2. Gasoline
アルコール	Noun, No-adjective:|1. alcohol||Wikipedia definition:|2. Alcohol
サンドイッチ	Noun:|1. sandwich||Wikipedia definition:|2. Sandwich
オートバイ	Noun:|1. motorcycle (Wasei, word made in Japan)||Wikipedia definition:|2. Motorcycle
サラダ	Noun:|1. salad||Wikipedia definition:|2. Salad
ソフト	Na-adjective, No-adjective:|1. soft||Noun:|2. software (Computer terminology, Abbreviation)|3. soft hat; felt hat (Abbreviation)|4. soft serve ice cream (Abbreviation)|5. softball (Abbreviation)||Wikipedia definition:|6. Soft
テキスト	Noun:|1. text|2. textbook||Wikipedia definition:|3. Text (literary theory)
ガソリンスタンド	Noun:|1. gas station; petrol station (Wasei, word made in Japan)||Wikipedia definition:|2. Filling station
ジャム	Noun:|1. jam||Wikipedia definition:|2. Fruit preserves
ステレオ	Noun:|1. stereo||Wikipedia definition:|2. Stereophonic sound
アナウンサー	Noun:|1. announcer; presenter; broadcaster; reporter|2. in-house television talent who does on-location fluff pieces for variety shows||Wikipedia definition:|3. Announcer
パート	Noun:|1. part|2. part-timer (Abbreviation)|3. part-time (work) (Abbreviation)||Wikipedia definition:|4. Part
アクセサリー	Noun:|1. accessory||Wikipedia definition:|2. Accessory
エスカレーター	Noun:|1. escalator||Wikipedia definition:|2. Escalator
あっ	:|1. ah; oh (expression of surprise, recollection, etc.)|2. hey! (used to get someone's attention)||Wikipedia definition:|3. A (kana)
スーツケース	Noun:|1. suitcase||Wikipedia definition:|2. Suitcase
ステーキ	Noun:|1. steak||Wikipedia definition:|2. Steak
あじあ	Noun, No-adjective:|1. Asia (Usually written using kana alone)||Wikipedia definition:|2. Asia
チェック	Noun, No-adjective:|1. check; plaid; checkered||Noun, Suru verb:|2. checking; monitoring; looking over; scrutinizing; inspecting||Noun:|3. check (banking); cheque; bill (restaurant)|4. check (chess)||Wikipedia definition:|5. Check
サンダル	Noun:|1. sandal||Wikipedia definition:|2. Sandal
スクリーン	Noun:|1. screen||Wikipedia definition:|2. Projection screen
開く	あく	Godan verb with ku ending, intransitive verb:|1. to open (e.g. doors) (esp. 開く)|2. to open (e.g. business, etc.) (esp. 開く)|3. to be empty (esp. 空く)|4. to be vacant; to be available; to be free (esp. 空く)|5. to be open (e.g. neckline, etc.) (esp. 明く)|6. to have been opened (of one's eyes, mouth, etc.) (esp. 明く)|7. to come to an end (esp. 明く)||Godan verb with ku ending, Transitive verb:|8. to open (one's eyes, mouth, etc.) (esp. 明く)||Godan verb with ku ending, intransitive verb:|9. to have a hole; to form a gap; to have an interval (between events)
一杯	いっぱい	Na-adjective, Adverb, Noun, No-adjective:|1. amount necessary to fill a container (e.g. cupful, spoonful, etc.); drink (usu. alcoholic)|2. full|3. one squid, octopus, crab, etc.; one boat||Adverb, No-adjective, Na-adjective:|4. fully; to capacity (Usually written using kana alone)|5. a lot; much (Usually written using kana alone)||Noun - used as a suffix, Adverbial noun:|6. all of ...; the entire ... (Usually written using kana alone)
用	よう	Noun:|1. business; task; errand; engagement|2. use; purpose||Noun - used as a suffix:|3. for the use of ...; used for ...; made for ...||Noun:|4. call of nature; excretion
レジ	Noun:|1. (cash) register (Abbreviation)|2. cashier (Abbreviation)
内	うち	Noun, No-adjective:|1. inside; within|2. while (Usually written using kana alone) (also 裡)|3. among; amongst; between (Usually written using kana alone)||Pronoun:|4. we; our (Usually written using kana alone) (in ref. to one's in-group, e.g. company, etc.)|5. my spouse||Noun:|6. imperial palace grounds (Archaism)|7. emperor (Archaism)||Pronoun:|8. I; me (Kansai dialect) (primarily used by women and children)
わけ	Noun:|1. conclusion from reasoning, judgement or calculation based on something read or heard; reason; cause; meaning; circumstances; situation (Usually written using kana alone)
おかげ	Noun:|1. grace (of God); benevolence (of Buddha); blessing (Usually written using kana alone)|2. assistance; help; aid (Usually written using kana alone)|3. effects; influence (Usually written using kana alone)
もうすぐ	Expression, Adverb:|1. soon; shortly; before long; nearly; almost (Usually written using kana alone)
君	くん	Noun, Suffix:|1. Mr (junior); master; boy
包む	つつむ	Godan verb with mu ending, Transitive verb:|1. to wrap up; to tuck in; to pack; to do up; to cover with; to dress in||Godan verb with mu ending:|2. to conceal; to hide; to be engulfed in; to be enveloped by
国際	こくさい	No-adjective, Noun:|1. international||Noun:|2. diplomatic intercourse (Obsolete term)||Wikipedia definition:|3. International
毛	け	Noun:|1. hair|2. fur; wool|3. down; plumage; feathers
泳ぎ方	およぎかた	Noun:|1. way of swimming
都	と	Noun, No-adjective:|1. metropolitan; municipal
家内	かない	Noun:|1. (my) wife (Humble (kenjougo))|2. inside the home; one's family
お見舞い	おみまい	Noun:|1. calling on someone who is ill; enquiry; inquiry
そう	Adverb:|1. so; really; seeming||Na-adjective, Suffix:|2. appearing that; seeming that; looking like; having the appearance of (after masu stem or adj-stem)
そんな	Pre-noun adjectival:|1. such (about the actions of the listener, or about ideas expressed or understood by the listener); like that; that sort of
もし	Adverb:|1. if; in case; supposing (Usually written using kana alone)
やめる	Ichidan verb, Transitive verb:|1. to stop (an activity); to cease; to discontinue; to end; to quit (Usually written using kana alone)|2. to cancel; to abandon; to give up; to abolish; to abstain; to refrain (Usually written using kana alone)
非常に	ひじょうに	Adverb:|1. very; extremely; exceedingly
だから	Conjunction:|1. so; therefore
はっきり	Adverb, Adverb taking the 'to' particle:|1. clearly; plainly; distinctly (Onomatopoeic or mimetic word)||Suru verb:|2. to be clear; to be definite; to be certain; to be exact; to become clear; to clear up (often as はっきりした)
すっかり	Adverb, Adverb taking the 'to' particle:|1. all; completely; totally; entirely; thoroughly (Onomatopoeic or mimetic word)
コンサート	Noun:|1. concert
やっと	Adverb:|1. at last; at length (Onomatopoeic or mimetic word)|2. barely; narrowly; just; by the skin of one's teeth (Onomatopoeic or mimetic word)
あんな	Pre-noun adjectival:|1. such (about something or someone distant from both speaker and listener, or about a situation unfamiliar to both speaker and listener); so; that; sort of
プレゼント	Noun:|1. present; gift||Suru verb:|2. to give a present or gift
タイプ	Noun:|1. type; kind; sort; style|2. type (of person); (ideal) type; one's type|3. typewriter (Abbreviation)||Noun, Suru verb:|4. typing
レポート	Noun, Suru verb:|1. report; paper
そろそろ	Adverb, Adverb taking the 'to' particle:|1. slowly; quietly; steadily; gradually; gingerly (Onomatopoeic or mimetic word)|2. soon; momentarily; before long; any time now (Onomatopoeic or mimetic word)
米	こめ	Noun:|1. (husked grains of) rice|2. 88 years old (米 is composed of 八十八)
ベル	Noun:|1. bell|2. bel; B
いらっしゃる	Godan verb - aru special class, intransitive verb:|1. to come; to go; to be (somewhere) (Honorific or respectful (sonkeigo)) (sometimes erroneously written 居らっしゃる)||Godan verb - aru special class, Auxiliary verb:|2. to be (doing) (Honorific or respectful (sonkeigo)) (after a -te form, or the particle "de")
それで	Conjunction:|1. and; thereupon; because of that (Usually written using kana alone)
どんどん	Adverb, Adverb taking the 'to' particle:|1. drumming (noise); beating; pounding; banging; booming; stamping (Onomatopoeic or mimetic word)|2. rapidly; quickly; steadily (Onomatopoeic or mimetic word)|3. continuously; one after the other; in succession (Onomatopoeic or mimetic word)
スーツ	Noun:|1. suit (clothing)|2. suit (playing cards)
ちゃん	Suffix:|1. suffix for familiar person (Familiar language)
ワープロ	Noun:|1. word processor (Computer terminology, Abbreviation)
汚れる	よごれる	Ichidan verb, intransitive verb:|1. to get dirty; to become dirty|2. to become sullied; to become corrupted; to lose one's chastity
パソコン	Noun, No-adjective:|1. personal computer (Computer terminology, Abbreviation)
ご馳走	ごちそう	Noun:|1. feast; treating (someone) (Polite (teineigo))||Suru verb:|2. to treat (someone, e.g. to a meal)
この頃	このごろ	Adverbial noun, Temporal noun:|1. recently; nowadays; these days; now; at present
アルバイト	Noun, Suru verb:|1. part-time job; side job||Noun:|2. part-time worker|3. albite
ハンドバッグ	Noun:|1. handbag; purse
すると	Conjunction:|1. thereupon; hereupon
さっき	Adverbial noun, Noun:|1. some time ago; just now
それに	Conjunction:|1. besides; in addition; also; moreover (Usually written using kana alone)
この間	このあいだ	Temporal noun, Adverbial noun:|1. the other day; lately; recently; during this period|2. meanwhile; in the meantime
ファックス	Noun:|1. fax; facsimile
すっと	Adverb, Suru verb:|1. straight; quickly; directly; all of a sudden (Onomatopoeic or mimetic word) (スーッと and すうっと are more emphatic)|2. quietly; gently; softly (Onomatopoeic or mimetic word)||Suru verb:|3. to feel refreshed; to feel satisfied
そんなに	Expression:|1. so much; so; like that
おっしゃる	Godan verb - aru special class, Transitive verb:|1. to say; to speak; to tell; to talk (Usually written using kana alone, Honorific or respectful (sonkeigo))
うん	:|1. yes; yeah; uh huh|2. hum; hmmm; well; erm|3. oof (moan or groan (of pain))
ああ	Adverb:|1. like that (used for something or someone distant from both speaker and listener); so
ご覧になる	ごらんになる	Expression, Godan verb with ru ending:|1. to see; to look; to watch (Honorific or respectful (sonkeigo))|2. to try to (after the -te form of a verb)
変わる	かわる	Godan verb with ru ending, intransitive verb:|1. to change; to be transformed; to be altered; to vary|2. to move to|3. to be different; to be uncommon; to be unusual (usu. as 変わった, 変わっている)
久しぶり	ひさしぶり	Na-adjective, No-adjective, Noun:|1. a long time (since the last time); first in a long time
昼休み	ひるやすみ	Adverbial noun, Temporal noun:|1. lunch break; noon recess; noon rest period
二階建て	にかいだて	Noun:|1. two-storied building
こう	Adverb:|1. in this way; thus; such (Usually written using kana alone) (used for something or someone close to the speaker, including the speaker himself, or for the opinions of the speaker)|2. uh... (Usually written using kana alone) (interjection used as a verbal pause)
おいでになる	Expression, Godan verb with ru ending:|1. to be (Usually written using kana alone, Honorific or respectful (sonkeigo))|2. to come|3. to go
お祭り	おまつり	Noun:|1. festival; feast; carnival (Polite (teineigo))
端	つま	Noun:|1. edge; tip; end|2. gable wall|3. gable
