学校	がっこう	Noun:|1. school||Wikipedia definition:|2. School
川	かわ	Noun:|1. river; stream||Suffix:|2. River; the ... river (suffix used with the names of rivers)||Wikipedia definition:|3. River
手	て	Noun:|1. hand; arm (occ. pronounced た when a prefix)|2. forepaw; foreleg (Colloquialism)|3. handle|4. hand; worker; help|5. trouble; care; effort|6. means; way; trick; move; technique; workmanship|7. hand; handwriting|8. kind; type; sort|9. one's hands; one's possession|10. ability to cope|11. hand (of cards)|12. direction||Noun, Noun - used as a suffix, Counter:|13. move (in go, shogi, etc.)||Wikipedia definition:|14. Hand
戸	と	Noun:|1. door (esp. Japanese-style)|2. shutter; window shutter|3. entrance (to a home) (Archaism)|4. narrows (Archaism)||Wikipedia definition:|5. Gate
眼鏡	めがね	Noun:|1. glasses; eyeglasses; spectacles|2. judgment; judgement; discrimination; discernment; insight||Wikipedia definition:|3. Glasses
たばこ	Noun:|1. tobacco; cigarette; cigaret; cigar (Usually written using kana alone)|2. tobacco plant (Nicotiana tabacum) (Usually written using kana alone)||Wikipedia definition:|3. Tobacco
赤	あか	Noun:|1. red; crimson; scarlet|2. red-containing colour (e.g. brown, pink, orange)|3. Red (i.e. communist) (Colloquialism) (often written as アカ)|4. red light (traffic) (Abbreviation)|5. red ink (i.e. in finance or proof-reading); (in) the red (Abbreviation)||No-adjective:|6. complete; total; perfect; obvious||Noun:|7. copper||Wikipedia definition:|8. Red
仕事	しごと	Noun, Suru verb, No-adjective:|1. work; job; business; occupation; employment; vocation; task|2. work (Physics terminology)||Wikipedia definition:|3. Work
英語	えいご	Noun, No-adjective:|1. English (language)||Wikipedia definition:|2. English language
問題	もんだい	Noun:|1. question (e.g. on a test); problem|2. problem (e.g. societal, political); question; issue; subject (e.g. of research); case; matter|3. question (i.e. doubt)|4. public discussion; controversy|5. trouble; problem; inconvenience; difficulty||Wikipedia definition:|6. Problem
部屋	へや	Noun:|1. room; chamber|2. apartment; flat; pad|3. stable (Sumo term, Abbreviation)||Wikipedia definition:|4. Room
子供	こども	Noun:|1. child||Wikipedia definition:|2. Child
時間	じかん	Noun:|1. time|2. hour||Wikipedia definition:|3. Time
雨	あめ	Noun:|1. rain||Wikipedia definition:|2. Rain
先生	せんせい	Noun:|1. teacher; master; doctor (Honorific or respectful (sonkeigo))||Suffix:|2. with names of teachers, etc. as an honorific (Honorific or respectful (sonkeigo))||Noun:|3. previous existence (Archaism)||Wikipedia definition:|4. Sensei
年	とし	Noun:|1. year|2. age; years|3. past one's prime; old age||Wikipedia definition:|4. Year
手紙	てがみ	Noun:|1. letter||Wikipedia definition:|2. Letter (message)
電話	でんわ	Noun, Suru verb, No-adjective:|1. telephone call; phone call||Noun, No-adjective:|2. telephone (device); phone (Abbreviation)||Wikipedia definition:|3. Telephony
水	みず	Noun:|1. water (esp. cool, fresh water, e.g. drinking water) (み is generally used in compounds)|2. fluid (esp. in an animal tissue); liquid|3. flood; floodwaters|4. water offered to wrestlers just prior to a bout (Sumo term)|5. break granted to wrestlers engaged in a prolonged bout (Sumo term)||Wikipedia definition:|6. Water
病気	びょうき	Noun, No-adjective, Suru verb:|1. illness; disease; sickness||Wikipedia definition:|2. Disease
会社	かいしゃ	Noun:|1. company; corporation|2. workplace||Wikipedia definition:|3. Company
上げる	あげる	Ichidan verb, Transitive verb:|1. to raise; to elevate|2. to do up (one's hair)|3. to fly (a kite, etc.); to launch (fireworks, etc.); to surface (a submarine, etc.)|4. to land (a boat)|5. to deep-fry|6. to show someone (into a room)|7. to summon (for geishas, etc.) (Usually written using kana alone)|8. to send someone (away)|9. to enrol (one's child in school); to enroll|10. to increase (price, quality, status, etc.); to develop (talent, skill); to improve|11. to make (a loud sound); to raise (one's voice)|12. to earn (something desirable)|13. to praise|14. to give (an example, etc.); to cite (usu. 挙げる)|15. to summon up (all of one's energy, etc.) (usu. 挙げる)|16. to arrest|17. to nominate|18. to give (Polite (teineigo))|19. to offer up (incense, a prayer, etc.) to the gods (or Buddha, etc.)|20. to bear (a child)|21. to conduct (a ceremony, esp. a wedding) (usu. 挙げる)||Ichidan verb, intransitive verb:|22. (of the tide) to come in||Ichidan verb, intransitive verb, Transitive verb:|23. to vomit||Auxiliary verb, Ichidan verb:|24. to do for (the sake of someone else) (Usually written using kana alone, Polite (teineigo)) (after the -te form of a verb)|25. to complete ... (after the -masu stem of a verb)|26. to humbly do ... (Humble (kenjougo)) (after the -masu stem of a humble verb to increase the level of humility)||Wikipedia definition:|27. Deep frying
結婚	けっこん	Noun, No-adjective, Suru verb:|1. marriage||Wikipedia definition:|2. Marriage
言葉	ことば	Noun:|1. language; dialect|2. word; words; phrase; term; expression; remark|3. speech; (manner of) speaking|4. learning to speak; language acquisition||Wikipedia definition:|5. Ci (poetry)
目	め	Noun:|1. eye; eyeball|2. eyesight; sight; vision|3. look; stare; gaze; glance|4. notice; attention; observation; eyes (of the world, public, etc.)|5. an experience|6. viewpoint|7. discrimination; discernment; judgement; eye (e.g. for quality)|8. appearance|9. spacing (between crossed strands of a net, mesh, etc.); opening; stitch; texture; weave|10. grain (of wood)|11. eye (of a storm, needle, etc.)|12. intersection (on a go board); square (on a chess board)|13. dot (on a dice); pip; rolled number|14. graduation; division (of a scale)|15. tooth (of a saw, comb, etc.)||Suffix:|16. ordinal number suffix|17. somewhat; -ish (Usually written using kana alone)|18. point (e.g. of change) (following -masu stem)||Wikipedia definition:|19. Eye
走る	はしる	Godan verb with ru ending, intransitive verb:|1. to run|2. to travel (movement of vehicles); to drive; to flow (e.g. energy)|3. to hurry to|4. to retreat (from battle); to take flight|5. to run away from home (esp. 奔る)|6. to elope|7. to tend heavily toward (esp. 趨る)|8. to flash; to streak; to shoot through (e.g. pain)||Wikipedia definition:|9. Running
名前	なまえ	Noun:|1. name; full name|2. given name; first name||Wikipedia definition:|3. Name
旅行	りょこう	Noun, Suru verb:|1. travel; trip; journey; excursion; tour||Wikipedia definition:|2. Travel
道	みち	Noun:|1. road; path; street; lane; passage|2. route; way|3. distance; journey|4. road (e.g. to victory); course|5. way (of living, proper conduct, etc.); moral principles|6. teachings (esp. Confucian or Buddhist); dogma|7. field (e.g. of medicine); subject; speciality|8. means; way; method||Wikipedia definition:|9. Diameter
飛行機	ひこうき	Noun:|1. aeroplane; airplane; aircraft||Wikipedia definition:|2. Fixed-wing aircraft
映画	えいが	Noun, No-adjective:|1. movie; film||Wikipedia definition:|2. Film
音楽	おんがく	Noun:|1. music||Wikipedia definition:|2. Music
木	き	Noun:|1. tree; shrub; bush|2. wood; timber||Wikipedia definition:|3. Tree
大学	だいがく	Noun:|1. university; college|2. former central university of Kyoto (established under the ritsuryo system for the training of government administrators) (Abbreviation)|3. the Great Learning (one of the Four Books)||Wikipedia definition:|4. University
時計	とけい	Noun:|1. watch; clock; timepiece||Wikipedia definition:|2. Clock
家族	かぞく	Noun, No-adjective:|1. family; members of a family||Wikipedia definition:|2. Family
花	はな	Noun:|1. flower; blossom; bloom; petal|2. cherry blossom|3. beauty|4. blooming (esp. of cherry blossoms)|5. ikebana|6. hanafuda (Abbreviation)|7. (the) best (usu. as 〜が花)||No-adjective:|8. glorious; lovely||Wikipedia definition:|9. Flower
猫	ねこ	Noun:|1. cat|2. shamisen|3. geisha|4. wheelbarrow (Abbreviation)|5. clay bed-warmer (Abbreviation)|6. bottom; submissive partner of a homosexual relationship (Usually written using kana alone, Colloquialism)||Wikipedia definition:|7. Cat
毎日	まいにち	Adverbial noun, Temporal noun:|1. every day||Wikipedia definition:|2. Every Single Day (band)
宿題	しゅくだい	Noun:|1. homework; assignment|2. pending issue; unresolved problem; open question||Wikipedia definition:|3. Homework
雪	ゆき	Noun:|1. snow||Wikipedia definition:|2. Snow
山	やま	Noun, Counter:|1. mountain; hill|2. mine (e.g. coal mine)|3. heap; pile||Noun:|4. crown (of a hat); thread (of a screw); tread (of a tire); protruding part of an object|5. climax; peak; critical point|6. guess; speculation|7. criminal case; crime (used by policemen, crime reporters, etc.)|8. mountain climbing; mountaineering|9. festival float (esp. one mounted with a decorative halberd)|10. wall; wall tile (Mahjong term)|11. temple; temple grounds (Archaism)||Noun - used as a prefix:|12. wild||Wikipedia definition:|13. Mountain
窓	まど	Noun:|1. window||Wikipedia definition:|2. Window
動物	どうぶつ	Noun:|1. animal||Wikipedia definition:|2. Animal
夜	よる	Adverbial noun, Temporal noun:|1. evening; night||Wikipedia definition:|2. Night
料理	りょうり	Noun, Suru verb:|1. cooking; cookery; cuisine|2. dealing with something; handling; administration; management (nuance of doing it easily)||Wikipedia definition:|3. Cuisine
夏	なつ	Adverbial noun, Temporal noun:|1. summer||Wikipedia definition:|2. Summer
新聞	しんぶん	Noun:|1. newspaper||Wikipedia definition:|2. Newspaper
公園	こうえん	Noun:|1. (public) park||Wikipedia definition:|2. Park
意味	いみ	Noun, Suru verb:|1. meaning; significance; sense||Wikipedia definition:|2. Meaning (linguistics)
自転車	じてんしゃ	Noun:|1. bicycle||Wikipedia definition:|2. Bicycle
足	あし	Noun:|1. foot (esp. 足)|2. leg (esp. 脚,肢)|3. gait|4. pace|5. bottom structural component (i.e. radical) of a kanji (usu. 脚)|6. means of transportation|7. money; coin (Archaism)||Wikipedia definition:|8. Foot
電車	でんしゃ	Noun:|1. train; electric train||Wikipedia definition:|2. Electric multiple unit
散歩	さんぽ	Noun, Suru verb:|1. walk; stroll||Wikipedia definition:|2. Strolling
声	こえ	Noun:|1. voice|2. singing (of a bird); chirping (of an insect); hoot|3. voice; opinion (as expressed in words); view; wish; attitude; will|4. sound|5. sense (of something's arrival); feeling (usu. as ～の声を聞く)|6. voice; voiced sound (linguistics terminology)||Wikipedia definition:|7. Human voice
朝	あさ	Adverbial noun, Temporal noun:|1. morning||Wikipedia definition:|2. Morning
歌	うた	Noun:|1. song (唄 is primarily used for shamisen songs)|2. classical Japanese poetry (esp. tanka)|3. modern poetry||Wikipedia definition:|4. Song
靴	くつ	Noun:|1. shoe; shoes; boots; footwear; footgear||Wikipedia definition:|2. Shoe
箱	はこ	Noun:|1. box; case; chest; package; pack; crate|2. car (of a train, etc.)|3. shamisen case; shamisen|4. public building; community building (Colloquialism) (often written as ハコ)|5. man who carries a geisha's shamisen (Archaism)|6. receptacle for human waste; feces (faeces) (Archaism)||Suffix, Counter:|7. counter for boxes (or boxed objects)||Wikipedia definition:|8. Box
机	つくえ	Noun:|1. desk||Wikipedia definition:|2. Desk
帽子	ぼうし	Noun:|1. hat; cap||Wikipedia definition:|2. Headgear
海	うみ	Noun:|1. sea; ocean; waters||Wikipedia definition:|2. Sea
授業	じゅぎょう	Noun, Suru verb:|1. lesson; class work; teaching; instruction||Wikipedia definition:|2. Lesson
銀行	ぎんこう	Noun, No-adjective:|1. bank||Wikipedia definition:|2. Bank
写真	しゃしん	Noun:|1. photograph; photo; picture; snapshot; snap|2. movie||Wikipedia definition:|3. Photography
冬	ふゆ	Adverbial noun, Temporal noun:|1. winter||Wikipedia definition:|2. Winter
村	むら	Noun:|1. village||Wikipedia definition:|2. Village
傘	かさ	Noun:|1. umbrella; parasol|2. something shaped like an umbrella or a conical hat; shade (of a lamp); mushroom cap; pileus||Wikipedia definition:|3. Umbrella
口	くち	Noun:|1. mouth|2. opening; hole; gap; orifice|3. mouth (of a bottle); spout; nozzle; mouthpiece|4. gate; door; entrance; exit|5. speaking; speech; talk (i.e. gossip)|6. taste; palate|7. mouth (to feed)|8. opening (i.e. vacancy); available position|9. invitation; summons|10. kind; sort; type|11. opening (i.e. beginning)||Suffix, Counter:|12. counter for mouthfuls, shares (of money), and swords||Wikipedia definition:|13. Mouth
橋	はし	Noun:|1. bridge||Wikipedia definition:|2. Bridge
病院	びょういん	Noun, No-adjective:|1. hospital||Wikipedia definition:|2. Hospital
図書館	としょかん	Noun:|1. library (also written 圕)||Wikipedia definition:|2. Library
春	はる	Adverbial noun, Temporal noun:|1. spring; springtime|2. New Year|3. prime (of one's life, etc.)|4. adolescence; puberty|5. sexuality||Wikipedia definition:|6. Spring (season)
買い物	かいもの	Noun:|1. shopping; purchased goods (買いもん is col.)||Wikipedia definition:|2. Shopping
椅子	いす	Noun:|1. chair; stool|2. post; office; position||Wikipedia definition:|3. Chair
自動車	じどうしゃ	Noun:|1. automobile||Wikipedia definition:|2. Automobile
色	いろ	Noun:|1. colour; color; hue; tint; tinge; shade|2. complexion; skin colour; skin color|3. look (on one's face); expression|4. appearance; air; feeling|5. personality; character|6. tone (of one's voice, etc.); tune; sound; ring|7. love; lust; sensuality; love affair|8. lover; paramour|9. beauty; sexiness; physical appeal|10. kind; type; variety (also written 種)||Wikipedia definition:|11. Color
卵	たまご	Noun:|1. eggs; egg; spawn; roe|2. hen egg|3. (an expert) in the making|4. beginning; origin; infancy||Wikipedia definition:|5. Egg (biology)
肉	にく	Noun:|1. flesh|2. meat|3. the physical body (as opposed to the spirit)|4. thickness|5. ink pad||Wikipedia definition:|6. Flesh
風邪	かぜ	Noun:|1. common cold; cold; influenza; flu; ague||Wikipedia definition:|2. Common cold
掃除	そうじ	Noun, Suru verb:|1. cleaning; sweeping; dusting; scrubbing||Wikipedia definition:|2. Cleanliness
紙	かみ	Noun:|1. paper||Wikipedia definition:|2. Paper
鍵	かぎ	Noun:|1. key|2. lock||Wikipedia definition:|3. Key (lock)
雑誌	ざっし	Noun:|1. journal; magazine; periodical||Wikipedia definition:|2. Magazine
切符	きっぷ	Noun:|1. ticket||Wikipedia definition:|2. Ticket
外国人	がいこくじん	Noun:|1. foreigner; foreign citizen; foreign national; alien; non-Japanese||Wikipedia definition:|2. Alien (law)
財布	さいふ	Noun:|1. purse; handbag; wallet||Wikipedia definition:|2. Wallet
鉛筆	えんぴつ	Noun:|1. pencil||Wikipedia definition:|2. Pencil
大人	おとな	Noun, No-adjective:|1. adult||Wikipedia definition:|2. Adult
塩	しお	Noun:|1. salt (i.e. sodium chloride); common salt; table salt (esp. しお)|2. salt (e.g. sodium chloride, calcium sulfate, etc.) (Chemistry term) (esp. えん)|3. hardship; toil; trouble|4. saltiness (Food term)||Wikipedia definition:|5. Salt
夏休み	なつやすみ	Noun:|1. summer vacation; summer holiday||Wikipedia definition:|2. Summer vacation
砂糖	さとう	Noun:|1. sugar||Wikipedia definition:|2. Sugar
郵便局	ゆうびんきょく	Noun:|1. post office||Wikipedia definition:|2. Post office
池	いけ	Noun:|1. pond||Wikipedia definition:|2. Pond
教室	きょうしつ	Noun:|1. classroom|2. department; laboratory|3. single-room school; small school||Wikipedia definition:|4. Classroom
耳	みみ	Noun:|1. ear|2. hearing|3. edge; crust|4. selvedge (non-fray machined edge of fabrics); selvage||Wikipedia definition:|5. Ear
切手	きって	Noun:|1. stamp (postage); merchandise certificate||Wikipedia definition:|2. Postage stamp
台所	だいどころ	Noun, No-adjective:|1. kitchen||Noun:|2. financial situation||Wikipedia definition:|3. Kitchen
電気	でんき	Noun:|1. electricity|2. (electric) light||Wikipedia definition:|3. Electricity
歯	は	Noun:|1. tooth||Wikipedia definition:|2. Human tooth
作文	さくぶん	Noun, Suru verb:|1. writing (an essay, prose, etc.); composition|2. formal writing with little real meaning||Wikipedia definition:|3. Composition (language)
紅茶	こうちゃ	Noun:|1. black tea||Wikipedia definition:|2. Black tea
家庭	かてい	Noun, No-adjective:|1. home; family; household||Wikipedia definition:|2. Home
野菜	やさい	Noun, No-adjective:|1. vegetable||Wikipedia definition:|2. Vegetable
風呂	ふろ	Noun:|1. bath; bathtub|2. bathroom; bathhouse|3. room for drying lacquerware|4. base (wooden joint connecting the blade of a hoe, spade, etc., to the handle)||Wikipedia definition:|5. Bathtub
玄関	げんかん	Noun:|1. entrance; front door; entryway; entranceway; entry hall; vestibule; porch; foyer; mud room||Wikipedia definition:|2. Genkan
地下鉄	ちかてつ	Noun:|1. underground train; subway||Wikipedia definition:|2. Rapid transit
鼻	はな	Noun:|1. nose||Wikipedia definition:|2. Nose
緑	みどり	No-adjective, Noun:|1. green||Noun:|2. greenery (esp. fresh verdure)||Wikipedia definition:|3. Green
昼	ひる	Noun:|1. noon; midday|2. daytime|3. lunch||Wikipedia definition:|4. Daylight
西	にし	Noun:|1. west||Wikipedia definition:|2. West
白	しろ	Noun:|1. white|2. innocence; innocent person|3. blank space|4. white go stone|5. white dragon tile (Mahjong term)|6. skewered grilled pig intestine (Food term)||Wikipedia definition:|7. White
洗濯	せんたく	Noun, Suru verb:|1. washing; laundry|2. relaxing; taking a break (oft. as 命の洗濯)||Wikipedia definition:|3. Laundry
冷蔵庫	れいぞうこ	Noun:|1. refrigerator||Wikipedia definition:|2. Refrigerator
火曜日	かようび	Adverbial noun, Temporal noun:|1. Tuesday||Wikipedia definition:|2. Tuesday
南	みなみ	Noun:|1. south||Wikipedia definition:|2. South
北	きた	Noun:|1. north|2. the North; northern territories|3. North Korea (Abbreviation)|4. north wind (Archaism)||Wikipedia definition:|5. North
茶色	ちゃいろ	Noun, No-adjective:|1. light brown; tawny||Wikipedia definition:|2. Brown
喫茶店	きっさてん	Noun:|1. coffee shop; tearoom; coffee lounge; coffeehouse; cafe||Wikipedia definition:|2. Kissaten
黒	くろ	Noun:|1. black|2. black go stone|3. guilt; guilty person||Wikipedia definition:|4. Black
青	あお	Noun, No-adjective:|1. blue; azure|2. green (mostly in compound words and in ref. to fruits, plants and traffic lights)||Noun:|3. green light (traffic) (Abbreviation)|4. black (horse coat color)||Prefix:|5. immature; unripe; young||Wikipedia definition:|6. Blue
靴下	くつした	Noun:|1. socks; sock; stockings; stocking||Wikipedia definition:|2. Sock
封筒	ふうとう	Noun:|1. envelope||Wikipedia definition:|2. Envelope
辺	へん	Noun:|1. area; vicinity; region|2. side; edge (Mathematics)|3. circumstances||Wikipedia definition:|4. Edge (geometry)
黄色	きいろ	Na-adjective, Noun:|1. yellow; amber||Wikipedia definition:|2. Yellow
映画館	えいがかん	Noun:|1. movie theatre; movie theater; cinema||Wikipedia definition:|2. Movie theater
箸	はし	Noun:|1. chopsticks||Wikipedia definition:|2. Chopsticks
食堂	しょくどう	Noun:|1. dining room; dining hall; cafeteria; messroom|2. restaurant; eatery; snack bar; diner||Wikipedia definition:|3. Dining room
牛肉	ぎゅうにく	Noun:|1. beef||Wikipedia definition:|2. Beef
交差点	こうさてん	Noun:|1. crossing; intersection||Wikipedia definition:|2. Intersection (road)
茶碗	ちゃわん	Noun:|1. rice bowl; tea cup; teacup||Wikipedia definition:|2. Chawan
漢字	かんじ	Noun:|1. Chinese characters; kanji||Wikipedia definition:|2. Chinese characters
曇り	くもり	Noun:|1. cloudiness; cloudy weather|2. fog (on a mirror, glasses, etc.); cloud (e.g. in marble); blur; mist; shadow; dimness|3. gloom; dejection||Wikipedia definition:|4. Overcast
背広	せびろ	Noun:|1. business suit (perhaps from "civil clothes" or "Savile Row")||Wikipedia definition:|2. Suit (clothing)
万年筆	まんねんひつ	Noun:|1. fountain pen||Wikipedia definition:|2. Fountain pen
灰皿	はいざら	Noun:|1. ashtray||Wikipedia definition:|2. Ashtray
大使館	たいしかん	Noun:|1. embassy||Wikipedia definition:|2. Diplomatic mission
豚肉	ぶたにく	Noun:|1. pork||Wikipedia definition:|2. Pork
交番	こうばん	Noun, Suru verb:|1. police box; small neighborhood police station||Noun, Noun or verb acting prenominally:|2. alternation; alternating (e.g. current)||Wikipedia definition:|3. Kōban
飲む	のむ	Godan verb with mu ending, Transitive verb:|1. to drink; to gulp; to swallow; to take (medicine) (呑む is often used metaphorically; 服む is often used for medicine)|2. to smoke (tobacco) (also written 喫む)|3. to engulf; to overwhelm|4. to keep down; to suppress|5. to accept (e.g. demand, condition)|6. to make light of; to conceal||Wikipedia definition:|7. Drinking
頭	あたま	Noun:|1. head|2. hair (on one's head)|3. mind; brains; intellect|4. leader; chief; boss; captain|5. top; tip|6. beginning; start|7. head; person|8. top structural component of a kanji|9. pair (Mahjong term, Colloquialism)||Wikipedia definition:|10. Neck
日曜日	にちようび	Adverbial noun, Temporal noun:|1. Sunday||Wikipedia definition:|2. Sunday
誕生日	たんじょうび	Noun:|1. birthday||Wikipedia definition:|2. Birthday
かわいい	I-adjective:|1. cute; adorable; charming; lovely; pretty (Usually written using kana alone)|2. dear; precious; darling; pet (Usually written using kana alone)|3. innocent; childlike; childish; lovable (Usually written using kana alone)|4. dainty; cute little; tiny (Usually written using kana alone)||Wikipedia definition:|5. Kawaii
かばん	Noun:|1. bag; satchel; briefcase; basket (Usually written using kana alone)||Wikipedia definition:|2. Paper bag
土曜日	どようび	Adverbial noun, Temporal noun:|1. Saturday||Wikipedia definition:|2. Saturday
月曜日	げつようび	Adverbial noun, Temporal noun:|1. Monday||Wikipedia definition:|2. Monday
金曜日	きんようび	Adverbial noun, Temporal noun:|1. Friday||Wikipedia definition:|2. Friday
花瓶	かびん	Noun:|1. (flower) vase||Wikipedia definition:|2. Vase
木曜日	もくようび	Adverbial noun, Temporal noun:|1. Thursday||Wikipedia definition:|2. Thursday
本棚	ほんだな	Noun:|1. bookshelves; bookshelf; bookcase||Wikipedia definition:|2. Bookcase
石鹸	せっけん	Noun:|1. soap||Wikipedia definition:|2. Soap
水曜日	すいようび	Adverbial noun, Temporal noun:|1. Wednesday||Wikipedia definition:|2. Wednesday
飴	あめ	Noun:|1. (hard) candy; toffee (Food term)|2. rice-sugar; sugar made from the starch of rice, potatoes, etc. (Food term)|3. amber; yellowish-brown (Abbreviation)||Wikipedia definition:|4. Yeot
八百屋	やおや	Noun:|1. greengrocer||Wikipedia definition:|2. Greengrocer
なる	Godan verb with ru ending, intransitive verb:|1. to become; to get; to grow; to be; to reach; to attain (Usually written using kana alone)|2. to result in; to prove to be|3. to consist of; to be composed of|4. to succeed; to be complete|5. to change into; to be exchanged for|6. to play a role|7. to be promoted (Shogi term)||Godan verb with ru ending:|8. to do ... (Honorific or respectful (sonkeigo)) (as お+masu-stem+になる, ご+noun+になる, etc.)
より	Particle:|1. than|2. from; out of; since; at; on|3. except; but; other than||Adverb:|4. more||Wikipedia definition:|5. Yori (kana)
一番	いちばん	Noun, No-adjective:|1. number one; first; first place||Adverb:|2. best; most||Noun:|3. game; round; bout||Adverb:|4. as a test; as an experiment; by way of experiment; by way of trial; tentatively||Noun:|5. song (e.g. in noh); piece
私	わたし	Pronoun:|1. I; me||Noun, No-adjective:|2. private affairs; personal matter; secrecy|3. selfishness
外	そと	Noun:|1. outside; exterior|2. open air|3. other place
姉	あね	Noun:|1. older sister; elder sister (Humble (kenjougo))
百	ひゃく	Numeric:|1. 100; hundred (陌 and 佰 are used in legal documents)
ある	Godan verb with ru ending (irregular verb), intransitive verb:|1. to be; to exist; to live (Usually written using kana alone) (usu. of inanimate objects)|2. to have (Usually written using kana alone)|3. to be located (Usually written using kana alone)|4. to be equipped with (Usually written using kana alone)|5. to happen; to come about (Usually written using kana alone)
その	Pre-noun adjectival:|1. that (something or someone distant from the speaker, close to the listener; actions of the listener, or ideas expressed or understood by the listener); the (Usually written using kana alone)|2. um...; er...; uh...
言う	いう	Godan verb with u ending:|1. to say; to utter; to declare|2. to name; to call|3. to go (e.g. "the alarm went ping"); to make a noise
できる	Ichidan verb, intransitive verb:|1. to be able (in a position) to do; to be up to the task (Usually written using kana alone)|2. to be ready; to be completed (Usually written using kana alone)|3. to be made; to be built (Usually written using kana alone)|4. to be good at; to be permitted (to do) (Usually written using kana alone)|5. to become intimate; to take up (with somebody) (Usually written using kana alone)|6. to grow; to be raised (Usually written using kana alone)|7. to become pregnant (Usually written using kana alone)
よい	I-adjective:|1. good; excellent; fine; nice; pleasant; agreeable (Usually written using kana alone) (also いい (all senses))|2. sufficient (can be used to turn down an offer); ready; prepared|3. profitable (e.g. deal, business offer, etc.); beneficial|4. OK
ください	Expression:|1. please give me (Usually written using kana alone, Honorific or respectful (sonkeigo))|2. please do for me (Usually written using kana alone, Honorific or respectful (sonkeigo)) (after te-form of a verb or a noun prefixed with o- or go-)
見る	みる	Ichidan verb, Transitive verb:|1. to see; to look; to watch; to view; to observe|2. to look over; to look on; to assess; to examine; to judge|3. to look after; to keep an eye on; to take care of (Usually written using kana alone)|4. to view (e.g. flowers, movie) (usu. 観る)||Auxiliary verb, Ichidan verb:|5. to try; to try out; to test (Usually written using kana alone) (usu. after a conative verb as 〜てみる)|6. to see that...; to find that... (Usually written using kana alone) (usu. after an aconative verb as 〜てみると, 〜てみれば, 〜てみたら, etc.)
この	Pre-noun adjectival:|1. this (something or someone close to the speaker (including the speaker), or ideas expressed by the speaker) (Usually written using kana alone)
自分	じぶん	Pronoun:|1. myself; yourself; oneself; himself; herself|2. I; me|3. you (Kansai dialect)
知る	しる	Godan verb with ru ending, Transitive verb:|1. to be aware of; to know; to be conscious of; to cognize; to cognise|2. to notice; to feel|3. to understand; to comprehend; to grasp|4. to remember; to be acquainted with (a procedure)|5. to experience; to go through; to learn|6. to be acquainted with (a person); to get to know|7. to concern
持つ	もつ	Godan verb with tsu ending:|1. to hold (in one's hand); to take; to carry|2. to possess; to have; to own|3. to maintain; to keep|4. to last; to be durable; to keep; to survive|5. to take charge of; to be in charge of
何	なに	Pronoun:|1. what||Prefix:|2. how many (followed by a counter)|3. large number of; many (followed by (optional number), counter and も)||Noun:|4. you-know-what; that||Expression:|5. whatsit; what's the expression; what do you call them|6. what? (expressing surprise)|7. hey! (expressing anger or irritability)
車	くるま	Noun:|1. car; automobile; vehicle|2. wheel
話す	はなす	Godan verb with su ending, Transitive verb:|1. to talk; to speak; to converse; to chat|2. to tell; to explain; to narrate; to mention; to describe; to discuss|3. to speak (a language)
今	いま	Adverbial noun, Noun:|1. now; the present time; just now; soon; immediately; (one) more
今日	きょう	Temporal noun:|1. today; this day|2. these days; recently; nowadays
買う	かう	Godan verb with u ending, Transitive verb:|1. to buy; to purchase (in western Japan, 買う conjugates euphonically as こうた, こうて, etc.)|2. to value; to have a high opinion|3. to stir; to provoke; to draw upon oneself
読む	よむ	Godan verb with mu ending, Transitive verb:|1. to read|2. to count (now mostly used in idioms)|3. to guess; to predict; to read (someone's thoughts); to see (e.g. into someone's heart); to divine
みんな	Adverb, Noun:|1. all; everyone; everybody (Usually written using kana alone)|2. everything (Usually written using kana alone)
新しい	あたらしい	I-adjective:|1. new; novel; fresh; recent; latest; up-to-date; modern
話	はなし	Noun:|1. talk; speech; chat; story; conversation|2. discussions; negotiation; argument
明日	あした	Temporal noun:|1. tomorrow|2. near future
昨日	きのう	Adverbial noun, Temporal noun:|1. yesterday
出る	でる	Ichidan verb, intransitive verb:|1. to leave; to exit; to go out; to come out; to get out|2. to leave (on a journey); to depart; to start out; to set out|3. to move forward|4. to come to; to get to; to lead to; to reach|5. to appear; to come out; to emerge; to surface; to come forth; to turn up; to be found; to be detected; to be discovered; to be exposed; to show; to be exhibited; to be on display|6. to appear (in print); to be published; to be announced; to be issued; to be listed; to come out|7. to attend; to participate; to take part; to enter (an event); to play in; to perform|8. to be stated; to be expressed; to come up; to be brought up; to be raised|9. to sell|10. to exceed; to go over|11. to stick out; to protrude|12. to break out; to occur; to start; to originate|13. to be produced|14. to come from; to be derived from|15. to be given; to get; to receive; to be offered; to be provided; to be presented; to be submitted; to be handed in; to be turned in; to be paid|16. to answer (phone, door, etc.); to get|17. to assume (an attitude); to act; to behave|18. to pick up (speed, etc.); to gain|19. to flow (e.g. tears); to run; to bleed|20. to graduate
勉強	べんきょう	Noun, Suru verb:|1. study|2. diligence|3. discount; reduction
取る	とる	Godan verb with ru ending, Transitive verb:|1. to take; to pick up; to harvest; to earn; to win; to choose|2. to steal|3. to eat; to have (a meal)|4. to remove (one's glasses, etc.) (also written as 脱る)|5. to compete (in sumo, cards, etc.); to play
誰	だれ	Pronoun:|1. who
お金	おかね	Noun:|1. money (Polite (teineigo))
男	おとこ	Noun, Noun - used as a prefix:|1. man; male||Noun:|2. fellow; guy; chap; bloke|3. male lover; boyfriend; man|4. manliness; manly honor; manly honour; manly reputation
犬	いぬ	Noun:|1. dog (Canis (lupus) familiaris)|2. snoop (i.e. a detective, a spy, etc.)|3. loser; asshole (Derogatory)||Noun - used as a prefix:|4. counterfeit; inferior; useless; wasteful
使う	つかう	Godan verb with u ending, Transitive verb:|1. to use (a thing, method, etc.); to make use of; to put to use|2. to use (a person, animal, puppet, etc.); to employ; to handle; to manage; to manipulate|3. to use (time, money, etc.); to spend; to consume|4. to use (language); to speak
大変	たいへん	Adverb:|1. very; greatly; terribly; awfully||Na-adjective, Noun:|2. immense; enormous; great|3. serious; grave; dreadful; terrible|4. difficult; hard||Noun:|5. major incident; disaster (Archaism)
待つ	まつ	Godan verb with tsu ending, Transitive verb, intransitive verb:|1. to wait|2. to await; to look forward to; to anticipate|3. to depend on; to need (usu. in negative form)
作る	つくる	Godan verb with ru ending, Transitive verb:|1. to make; to produce; to manufacture; to build; to construct (造る usu. for large-scale building, manufacturing, etc.; 創る usu. for creating)|2. to prepare (food); to brew (alcohol)|3. to raise; to grow; to cultivate; to train|4. to till|5. to draw up (a document); to make out; to prepare; to write|6. to create (an artistic work, etc.); to compose|7. to coin (a phrase); to organize; to organise; to establish; to found|8. to have (a child)|9. to make up (one's face, etc.)|10. to fabricate (an excuse, etc.)|11. to give a (false) appearance; to feign (a smile, etc.); to put on a show of emotion|12. to form (a line, etc.)|13. to set (a record)|14. to commit (a sin, etc.)
後ろ	うしろ	Noun, No-adjective:|1. back; behind; rear
町	まち	Noun:|1. town; block; neighbourhood; neighborhood|2. street; road|3. 109.09 m|4. 0.99 hectares|5. downtown; main street
駅	えき	Noun:|1. railway station; train station|2. staging post on a highway (in pre-modern Japan)
少し	すこし	Adverb, Noun:|1. small quantity; little; few; something|2. little while|3. short distance
あなた	Pronoun:|1. you (referring to someone of equal or lower status) (Usually written using kana alone, Polite (teineigo)) (貴女 refers only to females and 貴男 refers only to males)|2. dear (what a wife calls a husband)
欲しい	ほしい	I-adjective:|1. wanted; wished for; in need of; desired||Auxiliary adjective:|2. I want (you) to (Usually written using kana alone) (after the -te form of a verb)
行く	いく	Godan verb - Iku/Yuku special class, intransitive verb:|1. to go; to move (in a direction or towards a specific location); to head (towards); to be transported (towards); to reach|2. to proceed; to take place (い sometimes omitted in auxiliary use)|3. to pass through; to come and go|4. to walk|5. to die; to pass away|6. to do (in a specific way)|7. to stream; to flow||Auxiliary verb:|8. to continue||Godan verb - Iku/Yuku special class, intransitive verb:|9. to have an orgasm; to come; to cum (Usually written using kana alone)|10. to trip; to get high; to have a drug-induced hallucination (Usually written using kana alone, Slang)
乗る	のる	Godan verb with ru ending, intransitive verb:|1. to get on (train, plane, bus, ship, etc.); to get in; to board; to take; to embark|2. to get on (e.g. a footstool); to step on; to jump on; to sit on; to mount|3. to reach; to go over; to pass|4. to follow; to stay (on track); to go with (the times, etc.)|5. to take part; to participate; to join|6. to get into the swing (and sing, dance, etc.)|7. to be deceived; to be taken in|8. to be carried; to be spread; to be scattered (usu. with an adverb of manner, e.g. よく乗る)|9. to stick; to attach; to take; to go on (usu. with an adverb of manner, e.g. よく乗る)
大きな	おおきな	Pre-noun adjectival:|1. big; large; great
医者	いしゃ	Noun:|1. (medical) doctor; physician (お医者さん is polite)
終わる	おわる	Godan verb with ru ending, intransitive verb, Auxiliary verb:|1. to finish; to end; to close (also written 了る, 卒る, etc.)
学生	がくせい	Noun:|1. student (esp. a university student)
長い	ながい	I-adjective:|1. long (distance)|2. long (time); lengthy
どの	Pre-noun adjectival:|1. which; what (way) (Usually written using kana alone)
国	くに	Noun:|1. country; state|2. region|3. national government; central government|4. home (i.e. hometown, home country)|5. province (of Japan) (Archaism)|6. land; earth (Archaism)
また	Adverb, Conjunction, Prefix:|1. again; and; also; still (doing something) (Usually written using kana alone)
高い	たかい	I-adjective:|1. high; tall|2. expensive; high-priced|3. high (level); above average (in degree, quality, etc.)|4. loud|5. high-pitched; shrill
あまり	Noun, No-adjective:|1. remainder; remnant; rest; balance; surplus; remains (of a meal); leftovers (Usually written using kana alone)||Adverb:|2. not very; not much (Usually written using kana alone) (with neg. sentence)|3. too much; excessively; overly (Usually written using kana alone) (esp. as あまりに(も))||Na-adjective, No-adjective:|4. extreme; great; severe; tremendous; terrible||Noun - used as a suffix:|5. more than; over
難しい	むずかしい	I-adjective:|1. difficult; hard; troublesome; complicated; serious (disease, problem, etc.)|2. fussy; particular; fastidious; hard to please; displeased|3. gloomy; glum; sullen; serious (look)|4. dirty; unclean; filthy; detestable (Archaism)|5. unpleasant; uncomfortable; creepy; spooky (Archaism)
友達	ともだち	Noun:|1. friend; companion
本当	ほんとう	No-adjective, Na-adjective, Adverb, Noun:|1. truth; reality; actuality; fact||No-adjective, Na-adjective, Adverb:|2. proper; right; correct; official|3. genuine; authentic; natural; veritable
一つ	ひとつ	Numeric:|1. one||Noun:|2. for one thing (often used in itemized lists)|3. only (after a noun)|4. (not) even (with a verb in negative form)||Adverbial noun:|5. just (e.g. "just try it")
寝る	ねる	Ichidan verb, intransitive verb:|1. to lie down|2. to go to bed; to lie in bed|3. to sleep (lying down)|4. to sleep (with someone, i.e. have intercourse)|5. to lie idle
生徒	せいと	Noun:|1. pupil; student; schoolchild
忙しい	いそがしい	I-adjective:|1. busy; occupied; hectic|2. restless; hurried; fidgety
両親	りょうしん	Noun:|1. parents; both parents
泳ぐ	およぐ	Godan verb with gu ending, intransitive verb:|1. to swim
立つ	たつ	Godan verb with tsu ending, intransitive verb:|1. to stand; to rise; to stand up|2. to find oneself (e.g. in a difficult position)|3. to depart (on a plane, train, etc.) (usu. 発つ)
出す	だす	Godan verb with su ending, Transitive verb:|1. to take out; to get out|2. to put out; to reveal; to show|3. to submit (e.g. thesis); to turn in|4. to publish; to make public|5. to send (e.g. letter)|6. to produce (a sound); to start (fire)|7. to serve (food)||Suffix, Godan verb with su ending:|8. to begin ...; to start to ...; to burst into ... (after the -masu stem of a verb)
早い	はやい	I-adjective:|1. fast; quick; hasty; brisk (esp. 速い, 疾い, 捷い)|2. early (in the day, etc.); premature (esp. 早い)|3. (too) soon; not yet; (too) early (esp. 早い)|4. easy; simple; quick (esp. 早い)
楽しい	たのしい	I-adjective:|1. enjoyable; fun; pleasant; happy; delightful
面白い	おもしろい	I-adjective:|1. interesting; fascinating; intriguing; enthralling|2. amusing; funny; comical|3. pleasant; enjoyable; agreeable; fun
絵	え	Noun, Noun - used as a suffix:|1. picture; drawing; painting; sketch
女の子	おんなのこ	Expression, Noun:|1. girl; daughter|2. young woman
着る	きる	Ichidan verb, Transitive verb:|1. to wear (in modern Japanese, from the shoulders down); to put on|2. to bear (guilt, etc.)
上手	じょうず	Na-adjective, Noun:|1. skillful; skilled; proficient; good (at); adept; clever||Noun:|2. flattery
古い	ふるい	I-adjective:|1. old; aged; ancient; antiquated; antique; timeworn (of things, not people)|2. long; since long ago; time-honored|3. of the distant past; long-ago|4. stale; threadbare; hackneyed; corny|5. old-fashioned; outmoded; out-of-date
強い	つよい	I-adjective:|1. strong; potent; competent; domineering; tough|2. strong; brawny; powerful; healthy; rugged|3. good (at); skilled; knowledgeable|4. being able to handle; know how to deal (with); durable (against); resistant (to); resilient (as 〜に強い)|5. firm; rigid; solid|6. intense; strong; fierce; high|7. dependable; trustworthy
全部	ぜんぶ	Adverbial noun, Temporal noun, No-adjective:|1. all; entire; whole; altogether
呼ぶ	よぶ	Godan verb with bu ending, Transitive verb:|1. to call out (to); to call; to invoke|2. to summon (a doctor, etc.)|3. to invite|4. to designate; to name; to brand|5. to garner (support, etc.); to gather|6. to take as one's wife (Archaism)
午後	ごご	Adverbial noun, Temporal noun:|1. afternoon; p.m.
かける	Ichidan verb, Transitive verb:|1. to hang up (e.g. a picture on the wall); to let hang; to suspend (from); to hoist (e.g. sail); to raise (e.g. flag) (Usually written using kana alone)|2. to put on (e.g. a blanket); to put on top of; to cover (Usually written using kana alone)|3. to put on (glasses, etc.); to wear (a necklace, etc.) (Usually written using kana alone)|4. to make (a call) (Usually written using kana alone)|5. to spend (time, money); to expend; to use (Usually written using kana alone)|6. to pour (liquid) onto; to sprinkle (powder or spices) onto; to splash; to throw (e.g. water) onto somebody (Usually written using kana alone)|7. to turn on (an engine, radio, etc.); to set (a dial, an alarm clock, etc.); to put on (a DVD, a song, etc.) (Usually written using kana alone)|8. to cause (somebody inconvenience, trouble, etc.); to burden (someone); to impose (Usually written using kana alone)|9. to multiply (arithmetic operation) (Usually written using kana alone)|10. to secure (e.g. lock) (Usually written using kana alone)|11. to take a seat; to sit; to rest (something on something else); to support (something on something else) (Usually written using kana alone)|12. to bind (Usually written using kana alone) (also 繋ける)|13. to wager; to bet; to risk; to stake; to gamble (Usually written using kana alone)|14. to put an effect (spell, anaesthetic, etc.) on (Usually written using kana alone)|15. to hold (a play, festival, etc.) (Usually written using kana alone)|16. to hold an emotion for (pity, hope, etc.) (Usually written using kana alone)|17. to argue (in court); to deliberate (in a meeting); to present (e.g. idea to a conference, etc.) (Usually written using kana alone)|18. to increase further (Usually written using kana alone)|19. to catch (in a trap, etc.) (Usually written using kana alone)|20. to set atop (Usually written using kana alone)|21. to erect (a makeshift building) (Usually written using kana alone)|22. to apply (insurance) (Usually written using kana alone)|23. to pun (on a word); to use (a word) as a pivot word; to play on words (Usually written using kana alone)||Suffix, Ichidan verb:|24. to be partway doing ...; to begin (but not complete) ...; to be about to ... (Usually written using kana alone) (after -masu stem of verb)|25. to address (someone); to direct (something, to someone); to do (something, to someone) (Usually written using kana alone) (after -masu stem of verb; indicates (verb) is being directed to someone)
辞書	じしょ	Noun:|1. dictionary; lexicon|2. letter of resignation (Archaism)
天気	てんき	Noun:|1. weather; the elements|2. fair weather; fine weather
体	からだ	Noun, No-adjective:|1. body (からだ is a gikun reading of 身体)||Noun:|2. torso; trunk|3. build; physique; constitution||Noun, No-adjective:|4. health||Noun:|5. corpse; dead body
大きい	おおきい	I-adjective:|1. big; large; great|2. loud|3. extensive; spacious|4. important; decisive; valuable|5. older; grown up
夕べ	ゆうべ	Adverbial noun, Temporal noun:|1. evening|2. last night; yesterday evening (usu. 昨夜)
質問	しつもん	Noun, Suru verb, No-adjective:|1. question; inquiry; enquiry
有名	ゆうめい	Na-adjective:|1. famous||Noun:|2. fame
兄	あに	Noun:|1. elder brother; older brother (Humble (kenjougo))
歌う	うたう	Godan verb with u ending, Transitive verb, intransitive verb:|1. to sing||Godan verb with u ending, Transitive verb:|2. to sing (one's praises in a poem, etc.); to compose a poem; to recite a poem (esp. 歌う, 詠う)
上る	のぼる	Godan verb with ru ending, intransitive verb:|1. to ascend; to go up; to climb|2. to ascend (as a natural process, e.g. the sun); to rise (usu. 昇る)|3. to go to (the capital)|4. to be promoted|5. to add up to|6. to advance (in price)|7. to swim up (a river); to sail up|8. to come up (on the agenda)
服	ふく	Noun, Noun - used as a suffix:|1. clothes (esp. Western clothes)||Suffix, Counter:|2. counter for doses of medicine, gulps of tea, drags of a cigarette, etc.
鳥	とり	Noun:|1. bird|2. bird meat (esp. chicken meat); fowl; poultry
時々	ときどき	Adverb, Noun, No-adjective:|1. sometimes; at times
妹	いもうと	Noun:|1. younger sister (Humble (kenjougo))
二つ	ふたつ	Numeric:|1. two
頼む	たのむ	Godan verb with mu ending, Transitive verb:|1. to request; to beg; to ask|2. to call; to order; to reserve|3. to entrust to|4. to rely on (esp. 恃む)
お父さん	おとうさん	Noun:|1. father; dad; papa; pa; pop; daddy; dada (Honorific or respectful (sonkeigo))|2. husband (Honorific or respectful (sonkeigo))
今朝	けさ	Temporal noun:|1. this morning
遅い	おそい	I-adjective:|1. slow; time-consuming; sluggish|2. late (in the day); towards the end (of the day or night); until a time far into the day or night|3. later (than expected or usual); late; behind schedule; behind time; tardy; overdue; unpunctual|4. too late; having missed the boat|5. dull; stupid (Archaism)
薬	くすり	Noun:|1. medicine; pharmaceuticals; (legal) drugs; pill; ointment; salve|2. efficacious chemical (gunpowder, pesticide, etc.)|3. (pottery) glaze|4. small bribe
借りる	かりる	Ichidan verb, Transitive verb:|1. to borrow; to have a loan|2. to rent; to hire
庭	にわ	Noun:|1. garden; yard; courtyard|2. field (of action); area
外国	がいこく	Noun, No-adjective:|1. foreign country
小さい	ちいさい	I-adjective:|1. small; little; tiny|2. slight; below average (in degree, amount, etc.); minor; small|3. low (e.g. sound); soft (e.g. voice)|4. unimportant; petty; insignificant; trifling; trivial|5. young; juvenile
元気	げんき	Na-adjective, Noun:|1. lively; full of spirit; energetic; vigorous; vital; spirited|2. healthy; well; fit; in good health
弟	おとうと	Noun:|1. younger brother; little brother; kid brother (Humble (kenjougo))|2. pupil; apprentice (Archaism)
今年	ことし	Adverbial noun, Temporal noun:|1. this year
魚	さかな	Noun:|1. fish
お母さん	おかあさん	Noun:|1. mother; mom; mum; ma (Honorific or respectful (sonkeigo))|2. wife (Honorific or respectful (sonkeigo))
男の子	おとこのこ	Expression, Noun:|1. boy; male child; baby boy
飛ぶ	とぶ	Godan verb with bu ending, intransitive verb:|1. to fly; to soar (esp. 飛ぶ)|2. to jump; to leap; to spring; to bound; to hop (esp. 跳ぶ)
売る	うる	Godan verb with ru ending, Transitive verb:|1. to sell
静か	しずか	Na-adjective:|1. quiet; silent|2. slow; unhurried|3. calm; peaceful
休む	やすむ	Godan verb with mu ending, intransitive verb:|1. to be absent; to take a day off|2. to rest; to have a break|3. to go to bed; to (lie down to) sleep; to turn in; to retire|4. to stop doing some ongoing activity for a time; to suspend business
食べ物	たべもの	Noun:|1. food
大切	たいせつ	Na-adjective, Noun:|1. important; necessary; indispensable|2. beloved; precious; dear; cherished; valuable|3. careful (usu. adverb, as ～に)
警官	けいかん	Noun:|1. police officer; policeman; constable
来週	らいしゅう	Adverbial noun, Temporal noun:|1. next week
建物	たてもの	Noun:|1. building
暖かい	あたたかい	I-adjective:|1. warm; mild; (pleasantly) hot (暖かい usu. refers to air temperature)|2. considerate; kind; genial|3. warm (of a colour); mellow|4. having enough money
降りる	おりる	Ichidan verb, intransitive verb:|1. to descend (e.g. a mountain); to go down; to come down (esp. 下りる)|2. to alight (e.g. from bus); to get off; to disembark; to dismount (esp. 降りる)|3. to step down; to retire; to give up; to quit|4. to be granted; to be issued; to be given (esp. 下りる)|5. to form (of frost, dew, mist, etc.) (esp. 降りる)|6. to be passed (from the body; e.g. of a roundworm) (esp. 下りる)
止まる	とまる	Godan verb with ru ending, intransitive verb:|1. to stop (moving); to come to a stop|2. to stop (doing, working, being supplied); to come to a halt; to cease; to be stopped; to be suspended|3. to alight; to perch on
一緒	いっしょ	Adverbial noun, Noun, No-adjective:|1. together|2. at the same time|3. same; identical
先週	せんしゅう	Adverbial noun, Temporal noun:|1. last week; the week before
白い	しろい	I-adjective:|1. white
少ない	すくない	I-adjective:|1. few; a little; scarce; insufficient; seldom
二	に	Numeric:|1. two (ふ and ふう used mainly when counting aloud. 弐, 貳 and 貮 are used in legal documents.)
赤い	あかい	I-adjective:|1. red; crimson; scarlet; vermilion; vermillion (紅い is esp. for scarlet)|2. Red; communist|3. beautiful (Archaism)
洗う	あらう	Godan verb with u ending, Transitive verb:|1. to wash; to cleanse; to rinse|2. to inquire into; to investigate|3. to purify (one's heart)|4. to lave (e.g. shore); to wash over (e.g. deck); to sweep
嫌い	きらい	Na-adjective, Noun:|1. disliked; hated; disagreeable||Noun:|2. tendency; smack (of); touch (of) (Usually written using kana alone)|3. distinction; discrimination (Usually written using kana alone)
立派	りっぱ	Na-adjective:|1. splendid; fine; handsome; elegant; imposing; prominent|2. praiseworthy; creditable; worthy|3. legal; legitimate; lawful|4. undeniable (e.g. crime); indisputable; solid
暇	ひま	Na-adjective, Noun:|1. spare time; free time; leisure||Noun:|2. time (e.g. time it takes to do something)||Na-adjective, Noun:|3. time off; day off; vacation; holiday; leave|4. quitting (one's job); firing someone; divorcing (one's spouse)||Na-adjective:|5. (of one's time) free; (of one's business) slow||Noun:|6. leaving; departing
お茶	おちゃ	Noun:|1. tea (usu. green) (Polite (teineigo))|2. tea break (at work)|3. tea ceremony
広い	ひろい	I-adjective:|1. spacious; vast; wide
去年	きょねん	Adverbial noun, Temporal noun:|1. last year
大好き	だいすき	Na-adjective:|1. loveable; very likeable; like very much
隣	となり	Noun, No-adjective:|1. neighbor (neighbour); next to (esp. living next door to)
女	おんな	Noun, Noun - used as a prefix:|1. female; woman; female sex (can be blunt when used alone)||Noun:|2. female lover; girlfriend; mistress; (someone's) woman
切る	きる	Godan verb with ru ending, Transitive verb:|1. to cut; to cut through; to perform (surgery)|2. to sever (connections, ties)|3. to turn off (e.g. the light)|4. to terminate (e.g. a conversation); to hang up (the phone); to disconnect|5. to punch (a ticket); to tear off (a stub)|6. to open (something sealed)|7. to start|8. to set (a limit); to do (something) in less or within a certain time; to issue (stamps, vouchers, etc.)|9. to reduce; to decrease; to discount|10. to shake off (water, etc.); to let drip-dry; to let drain|11. to cross; to traverse|12. to criticize sharply|13. to act decisively; to do (something noticeable); to go first; to make (certain facial expressions, in kabuki)|14. to turn (vehicle, steering wheel, etc.)|15. to curl (a ball); to bend; to cut|16. to shuffle (cards)|17. to discard a tile (Mahjong term)|18. to dismiss; to sack; to let go; to expulse; to excommunicate|19. to dig (a groove); to cut (a stencil, on a mimeograph)|20. to trump|21. to cut (the connection between two groups) (in go)|22. to start a fire (with wood-wood friction or by striking a metal against stone) (also written as 鑽る)|23. to draw (a shape) in the air (with a sword, etc.)||Auxiliary verb, Godan verb with ru ending:|24. to finish; to complete (after the -masu stem of a verb)
多分	たぶん	Adverb:|1. perhaps; probably||Na-adjective, No-adjective:|2. generous; many; much; great
毎朝	まいあさ	Adverbial noun, Temporal noun:|1. every morning
嫌	いや	Na-adjective, Noun:|1. disagreeable; detestable; unpleasant; reluctant
荷物	にもつ	Noun:|1. luggage; baggage; package|2. burden|3. payload (of a packet, cell, etc.)
番号	ばんごう	Noun:|1. number; series of digits
返す	かえす	Godan verb with su ending, Transitive verb:|1. to return (something); to restore; to put back (esp. 返す)|2. to turn over; to turn upside down; to overturn|3. to pay back; to retaliate; to reciprocate (esp. 返す)||Suffix, Godan verb with su ending:|4. to repeat ...; to do ... back (after the -masu stem of a verb)
来年	らいねん	Adverbial noun, Temporal noun:|1. next year
明るい	あかるい	I-adjective:|1. light; well-lit; well-lighted|2. bright (of a colour); brightly-coloured; brightly-colored|3. cheerful; bright; spirited; sunny (e.g. disposition)|4. encouraging (for the future of a project, etc.); promising; of fair prospects|5. familiar (with); knowledgeable (about); well versed (in) (as 〜に明るい)|6. fair (e.g. politics); clean; impartial
近い	ちかい	I-adjective:|1. near; close; short (distance)|2. close (in time); soon|3. close (relationship); friendly; intimate|4. closely related|5. similar; likeworthy; almost the same
向こう	むこう	Noun:|1. opposite side; other side; opposite direction|2. over there; that way; far away; beyond|3. the other party; the other person|4. future (starting now)
始め	はじめ	Temporal noun, Adverbial noun:|1. beginning; start; outset; opening||Noun:|2. first (in line, etc.) (esp. 初め)|3. origin (esp. 始め)|4. such as ...; not to mention ... (Usually written using kana alone) (esp. 始め; as 〜を始め, 〜を始めとして, etc.)
痛い	いたい	I-adjective:|1. painful; sore|2. cringy; embarrassing (Colloquialism)||I-adjective, Suffix:|3. exceeding (esp. 甚い)
休み	やすみ	Noun:|1. rest; recess; respite|2. vacation; holiday; absence; suspension|3. dormancy (of a silkworm prior to moulting)
十	じゅう	Numeric:|1. ten (拾 is used in legal documents)
練習	れんしゅう	Noun, Suru verb:|1. practice; practising
先月	せんげつ	Adverbial noun, Temporal noun:|1. last month
上着	うわぎ	Noun:|1. coat; tunic; jacket; outer garment
結構	けっこう	Na-adjective, Adverbial noun, Noun:|1. splendid; nice; wonderful; delicious; sweet||Na-adjective:|2. sufficient; fine (in the sense of "I'm fine"); (by implication) no thank you|3. well enough; OK; tolerable||Adverb:|4. quite; reasonably; fairly; tolerably||Noun:|5. construction; architecture (Archaism)
毎年	まいとし	Temporal noun:|1. every year; yearly; annually
兄弟	きょうだい	Noun:|1. siblings; brothers and sisters|2. brothers|3. siblings-in-law; brothers-in-law; sisters-in-law|4. mate; friend (Familiar language, Male term or language)
来月	らいげつ	Adverbial noun, Temporal noun:|1. next month
五	ご	Numeric:|1. five (伍 is used in legal documents)
飲み物	のみもの	Noun:|1. drink; beverage
牛乳	ぎゅうにゅう	Noun:|1. (cow's) milk
弱い	よわい	I-adjective:|1. weak; frail; delicate; tender; unskilled; weak (wine)
三	さん	Numeric:|1. three (参 is used in legal documents)||Prefix:|2. tri-
大丈夫	だいじょうぶ	Na-adjective:|1. safe; secure; sound; problem-free; without fear; all right; alright; OK; okay||Adverb:|2. certainly; surely; undoubtedly||Na-adjective:|3. no thanks; I'm good; that's alright (Colloquialism)||Noun:|4. great man; fine figure of a man (Archaism)
黒い	くろい	I-adjective:|1. black|2. dark; blackish; sun-tanned (skin)|3. suspicious; criminal; illicit|4. darkened and dirty; sooty; covered in dirt|5. evil; wicked; black-hearted|6. inauspicious; ill-boding; unlucky
皆さん	みなさん	Noun:|1. all; everyone; everybody (Honorific or respectful (sonkeigo))
半分	はんぶん	Adverbial noun, Noun:|1. half
押す	おす	Godan verb with su ending, Transitive verb:|1. to push; to press|2. to apply pressure from above; to press down|3. to stamp (i.e. a passport); to apply a seal|4. to affix (e.g. gold leaf)|5. to press (someone for something); to urge; to compel; to influence|6. to overwhelm; to overpower; to repress|7. to push (events along); to advance (a plan)|8. to do in spite of ...; to do even though ...; to force|9. to make sure|10. to be pressed for time|11. to advance troops; to attack|12. (of light) to be diffused across an entire surface
勤める	つとめる	Ichidan verb, Transitive verb:|1. to work (for); to be employed (at); to serve (in) (usu. 勤める)|2. to serve (as); to act (as); to fill (the position of); to play the role (of) (usu. 務める)|3. to conduct a religious service (usu. 勤める)
熱い	あつい	I-adjective:|1. hot (thing)|2. passionate (feelings, etc.); ardent; hot (e.g. gaze)|3. hot (e.g. temper)|4. zealous; enthusiastic; fired up|5. intense; severe; extreme|6. hot (topic); of interest
三つ	みっつ	Numeric:|1. three
果物	くだもの	Noun:|1. fruit
今週	こんしゅう	Adverbial noun, Temporal noun:|1. this week
甘い	あまい	I-adjective:|1. sweet-tasting; sweet; sugary; sugared|2. fragrant (smelling); sweet (music)|3. lightly salted; light in salt; not spicy|4. naive; overly optimistic; soft on; generous; indulgent; easy-going; lenient|5. half-hearted; not finished properly|6. insufficient; not satisfactory; inadequate; loose|7. mild|8. tempting; enticing; luring
右	みぎ	Noun:|1. right; right hand side|2. afore-mentioned (esp. in vertical Japanese writing); foregoing; forgoing; above
晩	ばん	Adverbial noun, Temporal noun:|1. evening||Counter:|2. counter for nights
階段	かいだん	Noun:|1. stairs; stairway; staircase
いくつ	Adverb:|1. how many? (Usually written using kana alone)|2. how old?
大勢	おおぜい	Noun, No-adjective:|1. crowd of people; great number of people||Adverbial noun:|2. in great numbers
張る	はる	Godan verb with ru ending, Transitive verb:|1. to stick; to paste; to affix (esp. 貼る)||Godan verb with ru ending, intransitive verb, Transitive verb:|2. to stretch; to spread; to strain; to tighten; to put up (tent)||Godan verb with ru ending, intransitive verb:|3. to form (e.g. ice on a pond)||Godan verb with ru ending, intransitive verb, Transitive verb:|4. to fill; to swell||Godan verb with ru ending, Transitive verb:|5. to stick out; to put; to slap||Godan verb with ru ending, intransitive verb:|6. to be expensive||Godan verb with ru ending, Transitive verb:|7. to keep a watch on; to be on the lookout||Godan verb with ru ending, intransitive verb:|8. to become one tile away from completion (Mahjong term)||Godan verb with ru ending, Transitive verb:|9. to span; to generate (Mathematics)
夕方	ゆうがた	Adverbial noun, Temporal noun:|1. evening; dusk
低い	ひくい	I-adjective:|1. low (rank, degree, value, content, quality, etc.)|2. low (position); close to the ground|3. short (height)|4. deep (voice); in a low key; low (volume)
左	ひだり	Noun, No-adjective:|1. left; left hand side
毎週	まいしゅう	Adverbial noun, Temporal noun:|1. every week
下手	へた	Na-adjective, Noun:|1. unskillful; poor; awkward|2. imprudent; untactful
千	せん	Numeric:|1. 1,000; thousand (阡 and 仟 are used in legal documents)
渡す	わたす	Godan verb with su ending, Transitive verb:|1. to ferry across (e.g. a river); to carry across; to traverse|2. to lay across; to build across|3. to hand over; to hand in; to pass; to give; to transfer
午前	ごぜん	Adverbial noun, Temporal noun:|1. morning; a.m.
便利	べんり	Na-adjective:|1. convenient; handy; useful
丸い	まるい	I-adjective:|1. round; circular; spherical (丸い usu. refers to ball-shaped, and 円い to disc-shaped objects)|2. harmonious; calm
今月	こんげつ	Adverbial noun, Temporal noun:|1. this month
浴びる	あびる	Ichidan verb, Transitive verb:|1. to dash over oneself (e.g. water); to take (e.g. shower); to bask in (e.g. the sun); to bathe in; to be flooded with (e.g. light); to be covered in|2. to suffer (e.g. an attack); to draw (e.g. criticism, attention, praise); to have heaped upon; to be showered with
半	はん	Noun, Noun - used as a prefix:|1. half; semi-||Noun, Noun - used as a suffix:|2. half-past||Noun:|3. odd number|4. unit of land area (595.8 m^2) (Archaism)
洋服	ようふく	Noun:|1. Western-style clothes (cf. traditional Japanese clothes)
撮る	とる	Godan verb with ru ending, Transitive verb:|1. to take (a photo) (esp. 撮る)|2. to record (video, audio, etc.); to make (a film) (esp. 録る)
締める	しめる	Ichidan verb, Transitive verb:|1. to tie; to fasten; to tighten|2. to wear (necktie, belt); to put on|3. to total; to sum|4. to be strict with|5. to economize; to economise; to cut down on|6. to salt; to marinate; to pickle; to make sushi adding a mixture of vinegar and salt
文章	ぶんしょう	Noun:|1. writing; composition; essay; article; prose; (writing) style|2. sentence
薄い	うすい	I-adjective:|1. thin (in ref. to objects, not to people)|2. pale; light; faint|3. watery; thin; dilute|4. weak (taste, etc.); little (affection, etc.) not much (of a presence)|5. slim (probability, etc.); small|6. sparse; patchy; scattered
八	はち	Numeric:|1. eight (捌 is used in legal documents)
横	よこ	Noun:|1. horizontal (as opposed to vertical); lying down|2. side-to-side (as opposed to front-to-back); width; breadth|3. side (of a box, etc.)|4. beside; aside; next to|5. unconnected
六	ろく	Numeric:|1. six (陸 is used in legal documents)
四つ	よっつ	Numeric:|1. four||Noun:|2. four years of age|3. ten o'clock (old time system)|4. cross grips (Sumo term)
丈夫	じょうぶ	Na-adjective:|1. healthy; robust; strong; solid; durable (sometimes じょうふ)
毎晩	まいばん	Adverbial noun, Temporal noun:|1. every night
東	ひがし	Noun:|1. east
晴れ	はれ	Noun, No-adjective:|1. clear weather; fine weather||No-adjective, Noun:|2. formal; ceremonial; public|3. cleared of suspicion
五つ	いつつ	Numeric:|1. five
細い	ほそい	I-adjective:|1. thin; slender; fine|2. unlucky (billiards slang) (Slang)
廊下	ろうか	Noun:|1. corridor; hallway; passageway
太い	ふとい	I-adjective:|1. fat; thick|2. deep (of a voice); thick; sonorous|3. daring; shameless; brazen; audacious
縦	たて	Noun:|1. the vertical; height|2. front-to-back; length|3. north-to-south||Noun, No-adjective:|4. vertical (relationship); hierarchy||Noun:|5. (weaving) warp
留学生	りゅうがくせい	Noun:|1. overseas student; exchange student
九つ	ここのつ	Numeric:|1. nine
七つ	ななつ	Numeric:|1. seven
一昨年	いっさくねん	Adverbial noun, Temporal noun:|1. year before last
人	ひと	Noun:|1. man; person|2. human being; mankind; people|3. human (Homo sapiens); humans as a species (Usually written using kana alone)|4. character; personality|5. man of talent; true man|6. another person; other people; others|7. adult
いる	Ichidan verb, intransitive verb:|1. to be (of animate objects); to exist (Usually written using kana alone)|2. to stay (Usually written using kana alone)||Ichidan verb, Auxiliary verb:|3. to be ...-ing; to have been ...-ing (Usually written using kana alone) (after the -te form of a verb; indicates continuing action or state)
それ	Pronoun:|1. that (indicating an item or person near the listener, the action of the listener, or something on their mind); it (Usually written using kana alone)|2. that time; then|3. there (indicating a place near the listener) (Archaism)|4. you (Archaism)
物	もの	Noun:|1. thing; object; article; stuff; substance|2. one's things; possessions; property; belongings (as 〜のもの, 〜のもん)|3. things; something; anything; everything; nothing|4. quality|5. reason; the way of things|6. used to emphasize emotion, judgment, etc.; used to indicate a common occurrence in the past (after a verb in past tense); used to indicate a general tendency; used to indicate something that should happen (Usually written using kana alone) (formal noun often used as 〜ものだ)||Noun - used as a suffix:|7. item classified as ...; item related to ...; work of ...|8. cause of ...; cause for ...||Prefix:|9. somehow; somewhat; for some reason|10. really; truly
家	いえ	Noun:|1. house; residence; dwelling|2. family; household|3. lineage; family name
本	ほん	Noun:|1. book; volume; script||Prefix:|2. this; present|3. main; head|4. real; regular||Suffix, Counter:|5. counter for long cylindrical things; counter for films, TV shows, etc.; counter for goals, home runs, etc.; counter for telephone calls (sometimes pronounced ぼん or ぽん)
とても	Adverb:|1. very; awfully; exceedingly (Usually written using kana alone) (とっても is more emphatic)|2. (not) at all; by no means; simply (cannot) (Usually written using kana alone) (before a negative form)
会う	あう	Godan verb with u ending, intransitive verb:|1. to meet; to encounter; to see (逢う is often used for close friends, etc. and may be associated with drama or pathos; 遭う may have an undesirable nuance)|2. to have an accident; to have a bad experience (Usually written using kana alone) (esp. 遭う when in kanji)
好き	すき	Na-adjective, Noun:|1. liked; well-liked; favourite; favorite|2. in love (with); loved; romantically interested (in)||Noun, Na-adjective:|3. faddism; eccentricity|4. the way one likes; (as) it suits one
わかる	Godan verb with ru ending, intransitive verb:|1. to understand; to comprehend; to grasp; to see; to get; to follow (Usually written using kana alone)|2. to become clear; to be known; to be discovered; to be realized; to be realised; to be found out (Usually written using kana alone)
聞く	きく	Godan verb with ku ending, Transitive verb:|1. to hear|2. to listen (e.g. to music) (usu. 聴く)|3. to ask; to enquire; to query (聴く is more formal)|4. to learn of; to hear about|5. to follow (advice); to comply with|6. to smell (esp. incense); to sample fragrance
所	ところ	Noun, Suffix:|1. place; spot; scene; site (also pronounced どころ when a suffix)|2. address (Usually written using kana alone)|3. district; area; locality (Usually written using kana alone)|4. one's house (Usually written using kana alone)|5. point; aspect; side; facet (Usually written using kana alone)|6. passage (in text); part (Usually written using kana alone)|7. space; room (Usually written using kana alone)|8. thing; matter (Usually written using kana alone)||Noun:|9. whereupon; as a result (Usually written using kana alone) (after the plain past form of a verb)|10. about to; on the verge of (Usually written using kana alone) (after present form of a verb)|11. was just doing; was in the process of doing; have just done; just finished doing (Usually written using kana alone) (after past form of a verb)
先	さき	Noun, No-adjective, Noun - used as a suffix, Prefix:|1. previous; prior; former; first; earlier; some time ago; preceding|2. point (e.g. pencil); tip; end; nozzle|3. head (of a line); front|4. ahead; the other side|5. the future; hereafter|6. destination|7. the other party
いつも	Adverb, Noun:|1. always; usually; every time (Usually written using kana alone)|2. never (Usually written using kana alone) (with neg. verb)
書く	かく	Godan verb with ku ending, Transitive verb:|1. to write; to compose; to pen|2. to draw; to paint
たくさん	No-adjective, Na-adjective, Noun, Adverbial noun:|1. a lot; lots; plenty; many; a large number; much; a great deal; a good deal (Usually written using kana alone)|2. enough; sufficient (Usually written using kana alone)||Noun - used as a suffix:|3. enough; too many; too much (Usually written using kana alone) (after a noun; usu. read as だくさん)
入る	はいる	Godan verb with ru ending, intransitive verb:|1. to enter; to go into|2. to break into|3. to join; to enroll|4. to contain; to hold; to accommodate|5. to have (an income of)|6. to get; to receive; to score
置く	おく	Godan verb with ku ending, Transitive verb:|1. to put; to place|2. to leave (behind)|3. to establish (an organization, a facility, a position, etc.); to set up|4. to appoint (someone to a certain position); to hire; to employ|5. to place (one's trust, one's faith, etc); to bear (in mind etc)|6. to put down a tool (e.g. a pen) hence stopping what one is doing with that tool|7. to take in (boarders, etc.); to provide lodging in one's house|8. to separate spatially or temporally||Godan verb with ku ending, Auxiliary verb:|9. to do something in advance (Usually written using kana alone) (after the -te form of a verb)|10. to leave something in a certain state; to keep something in a certain state (Usually written using kana alone) (after the -te form of a verb)
どこ	Pronoun:|1. where; what place (Usually written using kana alone)|2. how much (long, far); what extent (Usually written using kana alone)
住む	すむ	Godan verb with mu ending, intransitive verb:|1. to live (of humans); to reside; to inhabit; to dwell; to abide
食べる	たべる	Ichidan verb, Transitive verb:|1. to eat|2. to live on (e.g. a salary); to live off; to subsist on
歩く	あるく	Godan verb with ku ending, intransitive verb:|1. to walk
働く	はたらく	Godan verb with ku ending, intransitive verb:|1. to work; to labor; to labour|2. to function; to operate; to be effective; to work (i.e. ... works); to come into play|3. to commit (e.g. a crime); to perpetrate; to do; to act; to practise; to practice|4. to be conjugated (linguistics terminology)
着く	つく	Godan verb with ku ending, intransitive verb:|1. to arrive at; to reach|2. to sit on; to sit at (e.g. the table)
上	うえ	Noun, No-adjective, Adverbial noun, Noun - used as a suffix:|1. above; up; over; elder (e.g. daughter)|2. top; summit|3. surface; on|4. before; previous|5. superiority; one's superior (i.e. one's elder)|6. on top of that; besides; what's more|7. upon (further inspection, etc.); based on (and occurring after)|8. matters concerning...; as concerns ...|9. since (i.e. "for that reason") (as ...上は)||Noun - used as a suffix:|10. suffix indicating higher social standing (Honorific or respectful (sonkeigo))|11. place of one's superior (i.e. the throne) (Archaism)|12. emperor; sovereign; shogun; daimyo (Archaism)|13. noblewoman (esp. the wife of a nobleman) (Archaism)
悪い	わるい	I-adjective:|1. bad; poor; inferior|2. evil; sinful|3. unprofitable; unbeneficial|4. at fault; to blame; in the wrong|5. sorry
教える	おしえる	Ichidan verb, Transitive verb:|1. to teach; to instruct|2. to tell; to inform|3. to preach
降る	ふる	Godan verb with ru ending, intransitive verb:|1. to fall (of rain, snow, ash, etc.); to come down|2. to form (of frost)|3. to beam down (of sunlight or moonlight); to pour in|4. to visit (of luck, misfortune, etc.); to come; to arrive
死ぬ	しぬ	Godan verb with nu ending, Irregular nu verb, intransitive verb:|1. to die; to pass away (Sensitive)|2. to lose spirit; to lose vigor; to look dead|3. to cease; to stop
帰る	かえる	Godan verb with ru ending, intransitive verb:|1. to return; to come home; to go home; to go back|2. to leave (of a guest, customer, etc.)|3. to get home; to get to home plate (Baseball term)
忘れる	わすれる	Ichidan verb, Transitive verb:|1. to forget; to leave carelessly; to be forgetful of; to forget about; to forget (an article)
多い	おおい	I-adjective:|1. many; numerous; a lot|2. large quantity; large amount|3. frequent; common
出かける	でかける	Ichidan verb, intransitive verb:|1. to go out (e.g. on an excursion or outing); to leave; to depart; to start; to set out|2. to be about to leave; to be just going out
若い	わかい	I-adjective:|1. young; youthful|2. immature; green|3. low (number); small
かかる	Godan verb with ru ending, intransitive verb:|1. to take (a resource, e.g. time or money) (Usually written using kana alone)||Godan verb with ru ending:|2. to hang (Usually written using kana alone)|3. to come into view; to arrive (Usually written using kana alone)|4. to come under (a contract, a tax) (Usually written using kana alone)|5. to start (engines, motors) (Usually written using kana alone)|6. to attend; to deal with; to handle (Usually written using kana alone)||Godan verb with ru ending, Auxiliary verb:|7. to have started to; to be on the verge of (Usually written using kana alone)||Godan verb with ru ending:|8. to overlap (e.g. information in a manual); to cover (Usually written using kana alone)||Godan verb with ru ending, Auxiliary verb:|9. to (come) at (Usually written using kana alone)||Godan verb with ru ending:|10. to be fastened (Usually written using kana alone)|11. to be covered (e.g. with dust, a table-cloth, etc.) (Usually written using kana alone)|12. to be caught in (Usually written using kana alone)|13. to get a call (Usually written using kana alone)|14. to depend on (Usually written using kana alone)
同じ	おなじ	Noun or verb acting prenominally, Noun:|1. same; identical; equal; uniform; equivalent; similar; common (origin); changeless; alike||Adverb:|2. anyway; anyhow; in either case (usu. part of a 'nara' conditional)
起きる	おきる	Ichidan verb, intransitive verb:|1. to get up; to rise; to blaze up (fire)|2. to wake up; to be awake; to stay awake|3. to occur (usu. of unfavourable incidents); to happen; to take place
座る	すわる	Godan verb with ru ending, intransitive verb:|1. to sit; to squat|2. to assume (a position)|3. to hold steady; to hold still (esp. 据わる, 据る)
店	みせ	Noun:|1. store; shop; establishment; restaurant (orig. an abbr. of 店棚;見世棚)
入れる	いれる	Ichidan verb, Transitive verb:|1. to put in; to let in; to take in; to bring in; to insert; to set (a jewel, etc.); to ink in (e.g. a tattoo)|2. to admit; to accept; to employ; to hire|3. to accept; to comply; to grant; to adopt (a policy, etc.); to take (advice, etc.); to listen to; to pay attention to (esp. 容れる)|4. to include|5. to pay (one's rent, etc.)|6. to cast (a vote)|7. to make (tea, coffee, etc.)|8. to turn on (a switch, etc.)|9. to send (a fax); to call
どなた	Noun:|1. who? (Usually written using kana alone, Honorific or respectful (sonkeigo))
ちょっと	Adverb:|1. a little; a bit; slightly (Usually written using kana alone)|2. just a minute; for a moment; briefly (Usually written using kana alone)|3. somewhat; rather; fairly; pretty; quite (Usually written using kana alone)|4. (not) easily; (not) readily (Usually written using kana alone) (before a verb in negative form)|5. hey!; excuse me (Usually written using kana alone)
疲れる	つかれる	Ichidan verb, intransitive verb:|1. to get tired; to tire|2. to be worn out (e.g. of well used objects)|3. to starve (Archaism)
開ける	あける	Ichidan verb, Transitive verb:|1. to open (a door, etc.); to unwrap (e.g. parcel, package); to unlock|2. to open (for business, etc.)|3. to empty; to remove; to make space; to make room (esp. 空ける)|4. to move out; to clear out (esp. 空ける)|5. to be away from (e.g. one's house); to leave (temporarily) (esp. 空ける)||Ichidan verb, intransitive verb:|6. to dawn; to grow light (esp. 明ける)|7. to end (of a period, season) (esp. 明ける)|8. to begin (of the New Year) (esp. 明ける)|9. to leave (one's schedule) open; to make time (for) (esp. 明ける)|10. to make (a hole); to open up (a hole)
なぜ	Adverb:|1. why; how (Usually written using kana alone)
一日	いちにち	Noun:|1. one day|2. first day of the month
寒い	さむい	I-adjective:|1. cold (e.g. weather)|2. uninteresting (esp. joke); lame; dull; weak; corny
見せる	みせる	Ichidan verb, Transitive verb:|1. to show; to display
違う	ちがう	Godan verb with u ending, intransitive verb:|1. to differ (from); to vary|2. to not be in the usual condition|3. to not match the correct (answer, etc.)|4. to be different from promised||Expression:|5. isn't it?; wasn't it? (Kansai dialect) (at sentence-end; oft. as 〜のと違うか)
どうして	Adverb:|1. why?; for what reason; how; in what way; for what purpose; what for (Usually written using kana alone)
付ける	つける	Ichidan verb, Transitive verb:|1. to attach; to join; to add; to append; to affix; to stick; to glue; to fasten; to sew on; to apply (ointment)|2. to furnish (a house with)|3. to wear; to put on|4. to keep a diary; to make an entry|5. to appraise; to set (a price)|6. to allot; to budget; to assign|7. to bring alongside|8. to place (under guard or doctor)|9. to follow; to shadow|10. to load; to give (courage to)|11. to keep (an eye on)|12. to establish (relations or understanding)|13. to turn on (light)|14. to produce flowers; to produce fruit (of a plant)
覚える	おぼえる	Ichidan verb, Transitive verb:|1. to memorize; to memorise; to commit to memory; to learn by heart; to bear in mind; to remember|2. to learn; to pick up; to acquire|3. to feel|4. to think; to regard
近く	ちかく	Noun, No-adjective, Adverbial noun:|1. near; neighbourhood; neighborhood; vicinity||Noun - used as a suffix:|2. nearly (e.g. "it took nearly one year"); close to||Adverb:|3. shortly; soon
風	かぜ	Noun:|1. wind; breeze; draught; draft||Noun, Noun - used as a prefix:|2. manner; behaviour; behavior||Noun:|3. cold; influenza (irreg. kanji form)
困る	こまる	Godan verb with ru ending, intransitive verb:|1. to be troubled; to be worried; to be bothered; to be embarrassed; to be stumped
生まれる	うまれる	Ichidan verb, intransitive verb:|1. to be born
ちょうど	Adverb:|1. exactly; precisely; just; right (Usually written using kana alone)|2. as if; as though; quite (Usually written using kana alone)
初めて	はじめて	Adverb, No-adjective:|1. for the first time||Adverb:|2. only after ... is it ...; only when ... do you ... (after the -te form of a verb)
始まる	はじまる	Godan verb with ru ending, intransitive verb:|1. to begin; to start; to commence|2. to happen (again); to begin (anew)|3. to date (from); to originate (in)
貸す	かす	Godan verb with su ending, Transitive verb:|1. to lend; to loan|2. to rent out; to hire out
きれい	Na-adjective:|1. pretty; lovely; beautiful; fair (Usually written using kana alone)|2. clean; clear; pure; tidy; neat (Usually written using kana alone)|3. completely; entirely (Usually written using kana alone) (as きれいに)
いくら	Adverb, Noun:|1. how much?; how many? (Usually written using kana alone)||Adverb:|2. even; even if
空	そら	Noun:|1. sky; the air; the heavens|2. weather|3. far-off place; distant place|4. state of mind; feeling (often as 〜空もない)|5. (from) memory; (by) heart (usu. as 空で)|6. falsehood; lie||Noun - used as a prefix:|7. somehow; vaguely (before an adjective)|8. fake (before a noun or a verb)
弾く	ひく	Godan verb with ku ending, Transitive verb:|1. to play (a stringed or keyboard instrument)
暑い	あつい	I-adjective:|1. hot; warm; sultry; heated|2. passionate; impassioned; burning (desire, etc.)|3. on everybody's mind; on the radar; du jour; interested (gaze, etc.)
遊ぶ	あそぶ	Godan verb with bu ending, intransitive verb:|1. to play; to enjoy oneself; to have a good time|2. to mess about (with alcohol, gambling, philandery, etc.)|3. to be idle; to do nothing; to be unused|4. to go to (for pleasure or for study) (as 〜に遊ぶ)|5. to intentionally throw a ball to lower the batter's concentration (Baseball term)
しかし	Conjunction:|1. however; but (Usually written using kana alone)
なくす	Godan verb with su ending, Transitive verb:|1. to lose (something); to mislay (Usually written using kana alone)|2. to get rid of; to eliminate; to remove (Usually written using kana alone)
いろいろ	Na-adjective, No-adjective, Adverb, Adverb taking the 'to' particle, Noun:|1. various; all sorts of; variety of (Usually written using kana alone)||Noun:|2. various colors (colours) (Archaism)
渡る	わたる	Godan verb with ru ending, intransitive verb:|1. to cross over; to go across (usu. 渡る or 渉る)|2. to extend; to cover; to range; to span (usu. 亘る or 亙る)
暗い	くらい	I-adjective:|1. dark; gloomy; murky|2. depressed; dispirited; down in the dumps; dark (mood)|3. dark (in colour); dull|4. ill-boding; dark (e.g. past); suspicious|5. unlikely (to succeed); hopeless; unpromising|6. unfamiliar (with); ignorant (of) (as 〜に暗い)
こちら	Noun:|1. this way (direction close to the speaker or towards the speaker); this direction (Usually written using kana alone)|2. here (place close to the speaker or where the speaker is)|3. this one (something physically close to the speaker)||Pronoun:|4. I; me; we; us|5. this person (someone physically close to the speaker and of equal or higher status)
重い	おもい	I-adjective:|1. heavy; weighty; massive|2. heavy (feeling); depressed; gloomy; blue; uneasy|3. slow; sluggish; lumbering; ponderous; clumsy|4. important; serious; grave (of a position, responsibility, etc.)|5. serious; severe; critical (of a punishment, illness, etc.)|6. solid; established; dignified; sensible
今晩	こんばん	Adverbial noun, Temporal noun:|1. tonight; this evening
おいしい	I-adjective:|1. delicious; tasty; sweet (Usually written using kana alone)|2. attractive; appealing; convenient; favorable; desirable; profitable (Usually written using kana alone)
消す	けす	Godan verb with su ending, Transitive verb:|1. to erase; to delete; to cross out|2. to turn off power|3. to extinguish; to put out|4. to bump off (Slang)
やさしい	I-adjective:|1. easy; plain; simple (Usually written using kana alone)
閉める	しめる	Ichidan verb, Transitive verb:|1. to close; to shut
安い	やすい	I-adjective:|1. cheap; inexpensive|2. calm; peaceful; quiet
遠い	とおい	I-adjective:|1. far; distant; far away; a long way off; in the distance|2. distant (past); remote (in time); remote; far-removed (in time)|3. distant (relationship or kinship); having little to do (with someone)|4. far (from something else in quality, degree, etc.); not similar; way off|5. hard (of hearing) (as 耳が遠い)|6. nearsighted (as 目が遠い)
短い	みじかい	I-adjective:|1. short
消える	きえる	Ichidan verb, intransitive verb:|1. to go out; to vanish; to disappear
晴れる	はれる	Ichidan verb, intransitive verb:|1. to clear up; to clear away; to be sunny; to stop raining|2. to refresh (e.g. spirits)|3. to be cleared (e.g. of a suspicion)|4. to be dispelled; to be banished
曲がる	まがる	Godan verb with ru ending, intransitive verb:|1. to bend; to curve; to warp; to wind; to twist|2. to turn|3. to be awry; to be askew; to be crooked
冷たい	つめたい	I-adjective:|1. cold (to the touch); chilly; icy; freezing|2. coldhearted; unfeeling; indifferent; unfriendly
青い	あおい	I-adjective:|1. blue; azure|2. green (mostly arch. or in ref. to fruits, vegetables and traffic lights, etc.)|3. pale; gray; grey (in ref. to facial colour)|4. unripe; inexperienced
ページ	Noun:|1. page (Usually written using kana alone) (頁 is sometimes ぺえじ or ぺいじ)
吹く	ふく	Godan verb with ku ending, Transitive verb, intransitive verb:|1. to blow (e.g. wind); to play a wind instrument|2. to whistle|3. to laugh; to burst into laughter (Slang) (often as 吹いた)||Godan verb with ku ending, Transitive verb:|4. to smelt; to mint|5. to brag; to talk big
奥さん	おくさん	Noun:|1. wife; your wife; his wife; married lady; madam (Honorific or respectful (sonkeigo))
引く	ひく	Godan verb with ku ending, Transitive verb:|1. to pull; to tug; to lead (e.g. a horse)|2. to draw (attention, sympathy, etc.); to attract (e.g. interest)|3. to draw back (e.g. one's hand); to draw in (one's chin, stomach, etc.); to pull in|4. to draw (a card, mahjong tile, etc.)|5. to draw (a line, plan, etc.)|6. to catch (a cold)|7. to play (a stringed or keyboard instrument)|8. to look up (e.g. a dictionary); to consult|9. to haul; to pull (vehicles) (esp. 牽く)|10. to subtract; to deduct|11. to recede; to ebb; to fade|12. to be descend from; to inherit (a characteristic)|13. to quote; to cite; to raise (as evidence)|14. to lay on (electricity, gas, etc.); to install (e.g. a telephone); to supply (e.g. water)|15. to hold (e.g. a note)|16. to apply (e.g. lipstick); to oil (e.g. a pan); to wax (e.g. a floor)||Godan verb with ku ending, intransitive verb:|17. to move back; to draw back; to recede|18. to lessen; to subside; to ebb|19. to resign; to retire; to quit
だんだん	Adverb, Adverb taking the 'to' particle:|1. gradually; by degrees; little by little; more and more; increasingly (Usually written using kana alone)||Noun:|2. steps; stairs; staircase; terrace
習う	ならう	Godan verb with u ending, Transitive verb:|1. to take lessons in; to be taught; to learn (from a teacher); to study (under a teacher); to get training in
あそこ	Pronoun:|1. there (place physically distant from both speaker and listener); over there; that place; yonder; you-know-where (Usually written using kana alone)||Noun:|2. genitals; private parts; nether regions (Colloquialism, Usually written using kana alone)|3. that far (something psychologically distant from both speaker and listener); that much; that point (Usually written using kana alone)
狭い	せまい	I-adjective:|1. narrow; confined; small; cramped|2. limited; narrow-minded; confining
軽い	かるい	I-adjective:|1. light (i.e. not heavy); feeling light (i.e. offering little resistance, moving easily)|2. light (i.e. of foot); effortless; nimble; agile|3. non-serious; minor; unimportant; trivial|4. slight; small; gentle; soft; easy; lighthearted (e.g. joke)|5. easy; simple|6. indiscriminate
脱ぐ	ぬぐ	Godan verb with gu ending, Transitive verb:|1. to take off (clothes, shoes, etc.); to undress
万	まん	Numeric:|1. 10,000; ten thousand (萬 is sometimes used in legal documents)||Noun, No-adjective:|2. myriad||Adverbial noun:|3. everything; all||Noun, No-adjective:|4. various (Archaism)
うるさい	I-adjective:|1. noisy; loud (Usually written using kana alone)|2. annoying; troublesome; tiresome; persistent; importunate (Usually written using kana alone)|3. fussy; finicky; picky; particular; nagging; fastidious; bossy (Usually written using kana alone)|4. shut up!; be quiet! (Usually written using kana alone)
並ぶ	ならぶ	Godan verb with bu ending, intransitive verb:|1. to line up; to stand in a line|2. to rival; to match; to equal
吸う	すう	Godan verb with u ending, Transitive verb:|1. to smoke; to breathe in; to inhale|2. to suck; to sip; to slurp|3. to absorb; to soak up|4. to kiss
つまらない	I-adjective:|1. dull; uninteresting; boring; tedious (Usually written using kana alone)|2. insignificant; unimportant; trifling; trivial; worthless (Usually written using kana alone)|3. absurd; foolish; silly; stupid (Usually written using kana alone)|4. useless; pointless; disappointing (Usually written using kana alone)
閉まる	しまる	Godan verb with ru ending, intransitive verb:|1. to be shut; to close; to be closed (esp. 閉まる)|2. to be firm (of a body, face, etc.); to be well-knit|3. to be locked|4. to tighten; to be tightened|5. to become sober; to become tense
咲く	さく	Godan verb with ku ending, intransitive verb:|1. to bloom
まっすぐ	Na-adjective, Adverb, Noun:|1. straight (ahead); direct; upright; erect (Usually written using kana alone)||Na-adjective, Noun:|2. straightforward; honest; frank (Usually written using kana alone)
一	いち	Numeric, Prefix:|1. one (１ can also be read ワン. 壱, 弌 and 壹 are used in legal documents)||No-adjective, Suffix:|2. best||No-adjective:|3. first; foremost||Noun:|4. beginning; start|5. ace (playing card)|6. bottom string (on a shamisen, etc.)
おばあさん	Noun:|1. grandmother (Usually written using kana alone) (usu. お祖母さん)|2. old woman; female senior citizen (Usually written using kana alone) (usu. お婆さん)
そちら	Pronoun:|1. that way (direction distant from the speaker, close to the listener) (Usually written using kana alone)|2. there (place distant from the speaker, close to the listener)|3. that one (something close to the listener)|4. you; your family; your company|5. that person (someone close to the listener)
涼しい	すずしい	I-adjective:|1. cool; refreshing|2. clear (e.g. eyes); bright|3. clear; distinct|4. composed (facial expression); unruffled; unconcerned|5. pure; upright; innocent (Archaism)
厚い	あつい	I-adjective:|1. thick; deep; heavy|2. kind; cordial; hospitable; warm; faithful|3. serious (of an illness)|4. abundant
お兄さん	おにいさん	Noun:|1. older brother; elder brother (Honorific or respectful (sonkeigo))|2. young man; buddy; fella; laddie (vocative)
お姉さん	おねえさん	Noun:|1. elder sister (Honorific or respectful (sonkeigo)) (usu. お姉さん)|2. young lady (vocative)|3. miss (referring to a waitress, etc.; usu. お姐さん)|4. ma'am (used by geisha to refer to their superiors; usu. お姐さん)|5. older girl
危ない	あぶない	I-adjective:|1. dangerous; risky; hazardous; perilous; precarious|2. in danger; in jeopardy; critical; grave; at risk|3. uncertain; unreliable; insecure; unsteady; doubtful|4. close (i.e. a close call); narrow
汚い	きたない	I-adjective:|1. dirty; filthy; foul; unclean|2. disordered; messy; untidy; poor (e.g. handwriting)|3. indecent (language, etc.); dirty; vulgar; coarse|4. dastardly; mean; base; underhanded|5. stingy; greedy
並べる	ならべる	Ichidan verb, Transitive verb:|1. to line up; to set up; to arrange in a line|2. to enumerate; to itemize|3. to be equal (to); to compare well (with); to be as good (as)
お腹	おなか	Noun:|1. belly; abdomen; stomach (Polite (teineigo))
まずい	I-adjective:|1. unappetising; unappetizing; unsavoury; unsavory; unpleasant (Usually written using kana alone)|2. unskillful; unskilful; bungling; clumsy; poor (Usually written using kana alone)|3. ugly; unattractive; homely; plain (Usually written using kana alone)|4. awkward; problematic; troublesome; unfavorable; unfavourable; unwise (Usually written using kana alone)
曇る	くもる	Godan verb with ru ending, intransitive verb:|1. to get cloudy; to cloud over; to become overcast|2. to cloud up; to fog up; to mist up; to become dim|3. to be gloomy; to be clouded (expression); to be downcast|4. to look slightly downward (of a noh mask; indicating sadness, grief, etc.) (from 面曇る)
ご飯	ごはん	Noun:|1. cooked rice|2. meal
お菓子	おかし	Noun:|1. confections; sweets; candy
黄色い	きいろい	I-adjective:|1. yellow|2. high-pitched (voice); shrill
磨く	みがく	Godan verb with ku ending, Transitive verb:|1. to polish; to shine; to brush (e.g. teeth); to grind (e.g. lens)|2. to refine (e.g. a skill); to improve; to cultivate
賑やか	にぎやか	Na-adjective:|1. bustling; busy; lively
鳴く	なく	Godan verb with ku ending, intransitive verb:|1. to sing (bird)|2. to make sound (animal); to call; to cry; to chirp|3. to make a meld call (e.g. pung, kong) (Mahjong term)
夕飯	ゆうはん	Noun:|1. evening meal
はがき	Noun:|1. postcard (Abbreviation, Usually written using kana alone)|2. memo; note; card (Usually written using kana alone)
ワイシャツ	Noun:|1. shirt; business shirt; dress shirt (Usually written using kana alone, Abbreviation, Wasei, word made in Japan)
朝ご飯	あさごはん	Noun:|1. breakfast
六つ	むっつ	Numeric:|1. six
お手洗い	おてあらい	Noun:|1. toilet; restroom; lavatory; bathroom
おまわりさん	Noun:|1. police officer (Familiar language, Usually written using kana alone)
差す	さす	Godan verb with su ending, intransitive verb:|1. to shine|2. to be visible|3. to be tinged with|4. to rise (of water levels); to flow in|5. to be felt (i.e. as an emotion); to come over one||Godan verb with su ending, Transitive verb:|6. to hold up (an umbrella, etc.); to put up; to raise|7. to extend one's arm straight ahead (in dance)|8. to insert; to put in|9. to wear (a sword) in one's belt; to wear at one's side; to carry under one's arm|10. to insert one's arm under an opponent's arm (Sumo term)|11. to pole (a boat)|12. to pour; to add (liquid); to serve (drinks)|13. to put on (lipstick, etc.); to apply; to colour; to dye|14. to light (a fire); to burn|15. to shut; to close; to lock; to fasten||Suffix, Godan verb with su ending:|16. to stop in the midst of; to leave undone (after the -masu stem of a verb)
れい	Noun, No-adjective:|1. zero; nought (Usually written using kana alone)
二十日	はつか	Noun:|1. twentieth day of the month|2. twenty days
キロメートル	Noun:|1. kilometer; kilometre (Usually written using kana alone)
八つ	やっつ	Numeric:|1. eight
再来年	さらいねん	Adverbial noun, Temporal noun:|1. year after next
よく	Adverb:|1. nicely; properly; well; skillfully; skilfully (Usually written using kana alone)|2. frequently; often (Usually written using kana alone)
そこ	Pronoun:|1. there (place relatively near listener) (Usually written using kana alone)|2. there (place just mentioned); that place (Usually written using kana alone)|3. then (of some incident just spoken of); that (of point just raised) (Usually written using kana alone)|4. you (Archaism)
小さな	ちいさな	Pre-noun adjectival:|1. small; little; tiny
答える	こたえる	Ichidan verb, intransitive verb:|1. to answer; to reply
もう一度	もういちど	Expression:|1. once more; again
いる	Godan verb with ru ending, intransitive verb:|1. to be needed; to be wanted (Usually written using kana alone)
背	せ	Noun:|1. back; spine|2. reverse; rear side|3. height; stature|4. ridge (of a mountain)
お弁当	おべんとう	Noun:|1. bento; Japanese box lunch
晩御飯	ばんごはん	Noun:|1. dinner; evening meal
でも	Conjunction:|1. but; however; though; nevertheless; still; yet; even so; also; as well||Particle:|2. even|3. however; no matter how; even if; even though|4. ... or something|5. either ... or ...; neither ... nor ... (as 〜でも〜でも)||Prefix:|6. pseudo-; quack; in-name-only (before an occupation, etc.)|7. for lack of anything better to do (before an occupation, etc.)
など	Particle:|1. et cetera; etc.; and the like; and so forth (Usually written using kana alone)|2. or something (Usually written using kana alone) (after an approximate quote or vague suggestion)|3. the likes of (Usually written using kana alone) (lessening the significance or value of the previous word)
クラス	Noun:|1. class||Wikipedia definition:|2. Class
プール	Noun:|1. (swimming) pool||Noun, Suru verb:|2. pool (billiards)|3. pool (together)||Wikipedia definition:|4. Swimming pool
中	なか	Noun:|1. inside; in|2. among; within|3. center (centre); middle|4. during; while||Wikipedia definition:|5. Naka
テレビ	Noun:|1. television; TV (Abbreviation)|2. TV program; TV programme; TV broadcast (Abbreviation)||Wikipedia definition:|3. Television
コーヒー	Noun, No-adjective:|1. coffee (Usually written using kana alone)||Wikipedia definition:|2. Coffee
ホテル	Noun:|1. hotel||Wikipedia definition:|2. Hotel
ニュース	Noun:|1. news||Wikipedia definition:|2. News
テーブル	Noun, No-adjective:|1. table||Wikipedia definition:|2. Table
カメラ	Noun:|1. camera||Wikipedia definition:|2. Camera
タクシー	Noun:|1. taxi||Wikipedia definition:|2. Taxicab
スポーツ	Noun, No-adjective:|1. sport; sports||Wikipedia definition:|2. Sport
ラジオ	Noun:|1. radio||Wikipedia definition:|2. Radio
ペン	Noun:|1. pen||Wikipedia definition:|2. Pen
レストラン	Noun:|1. restaurant (esp. Western-style)||Wikipedia definition:|2. Restaurant
テスト	Noun, Suru verb:|1. test||Wikipedia definition:|2. Test
ベッド	Noun:|1. bed||Wikipedia definition:|2. Bed
パン	Noun:|1. bread; pastries (e.g. croissants); pastry-based products (originally written 麺麭 or 麪包)|2. pan; frying pan||Noun, Suru verb:|3. panning (in a film)||Wikipedia definition:|4. Bread
ナイフ	Noun:|1. knife||Wikipedia definition:|2. Knife
シャツ	Noun:|1. shirt (underwear); undershirt; singlet (also written as 襯衣)|2. shirt (outerwear, esp. dress shirt)||Wikipedia definition:|3. Shirt
ネクタイ	Noun:|1. tie; necktie||Wikipedia definition:|2. Necktie
ギター	Noun:|1. guitar||Wikipedia definition:|2. Guitar
メートル	Noun:|1. metre; meter (Usually written using kana alone)|2. meter; gauge||Wikipedia definition:|3. Rice
セーター	Noun:|1. sweater; jumper||Wikipedia definition:|2. Sweater
アパート	Noun:|1. apartment building; apartment block; apartment house (Abbreviation)|2. apartment (Abbreviation)||Wikipedia definition:|3. Apartment
ポケット	Noun:|1. pocket||Wikipedia definition:|2. Pocket
バター	Noun:|1. butter||Wikipedia definition:|2. Butter
キロ	Prefix:|1. kilo-; 1000||Noun:|2. kilogram; kilogramme (Abbreviation)|3. kilometre; kilometer (Abbreviation)||Prefix:|4. kilo-; 1024; 2^10 (Computer terminology)||Wikipedia definition:|5. Kilo-
スカート	Noun:|1. skirt||Wikipedia definition:|2. Skirt
レコード	Noun:|1. record (e.g. LP)|2. record (e.g. in sports)|3. record (data structure) (Computer terminology)||Wikipedia definition:|4. Gramophone record
エレベーター	Noun:|1. elevator; lift|2. elevator (aviation)||Wikipedia definition:|3. Elevator
ズボン	Noun:|1. trousers; pants (also written as 洋袴 and 段袋 during the Meiji period)||Wikipedia definition:|2. Trousers
ポスト	Noun:|1. postbox; mail box; pillar box|2. post; position|3. post (e.g. goalpost)||Noun or verb acting prenominally:|4. post- (e.g. post-Cold War)||Wikipedia definition:|5. Post
コピー	Noun, Suru verb:|1. copy; photocopy|2. blurb on a book jacket|3. catch copy (Abbreviation)||Wikipedia definition:|4. Copy
シャワー	Noun:|1. shower||Wikipedia definition:|2. Shower
ハンカチ	Noun:|1. handkerchief (Abbreviation)||Wikipedia definition:|2. Handkerchief
一昨日	おととい	Adverbial noun, Temporal noun:|1. day before yesterday||Wikipedia definition:|2. Daytime (astronomy)
ストーブ	Noun:|1. (room) heater; stove||Wikipedia definition:|2. Kitchen stove
テープ	Noun:|1. tape||Wikipedia definition:|2. Tape
カップ	Noun:|1. cup (drinking vessel, measure, brassiere, prize, etc.)|2. instant noodles purchased in cup; cup noodles (Abbreviation)||Wikipedia definition:|3. Cup
テープレコーダー	Noun:|1. tape recorder||Wikipedia definition:|2. Tape recorder
ボールペン	Noun:|1. ball-point pen (Wasei, word made in Japan)||Wikipedia definition:|2. Ballpoint pen
スプーン	Noun:|1. spoon||Wikipedia definition:|2. Spoon
スリッパ	Noun:|1. slipper; slippers||Wikipedia definition:|2. Slipper
醤油	しょうゆ	Noun:|1. soy sauce; shoyu (しょゆ, しょゆう are dial.)||Wikipedia definition:|2. Soy sauce
はい	:|1. yes; that is correct (Polite (teineigo))|2. understood; I see; OK; okay|3. present; here (as a response to a roll call)|4. pardon?; what's that?; come again? (Colloquialism) (with rising intonation)|5. now; here; here you go (used when calling for someone's attention or when handing something to someone)|6. giddy-up; giddap||Wikipedia definition:|7. Yes and no
ペット	Noun:|1. pet|2. trumpet (Abbreviation)||Wikipedia definition:|3. Pet
する	Suru verb - irregular:|1. to do; to carry out; to perform (Usually written using kana alone)|2. to cause to become; to make (into); to turn (into) (Usually written using kana alone)|3. to serve as; to act as; to work as (Usually written using kana alone)|4. to wear (clothes, a facial expression, etc.) (Usually written using kana alone)|5. to judge as being; to view as being; to think of as; to treat as; to use as (Usually written using kana alone) (as 〜にする,〜とする)|6. to decide on; to choose (Usually written using kana alone) (as 〜にする)||Suru verb - irregular, intransitive verb:|7. to be sensed (of a smell, noise, etc.) (Usually written using kana alone) (as 〜がする)|8. to be (in a state, condition, etc.) (Usually written using kana alone)|9. to be worth; to cost (Usually written using kana alone)|10. to pass (of time); to elapse (Usually written using kana alone)||Suru verb - irregular, Transitive verb:|11. to place, or raise, person A to a post or status B (Usually written using kana alone) (as AをBにする)|12. to transform A to B; to make A into B; to exchange A for B (Usually written using kana alone) (as AをBにする)|13. to make use of A for B; to view A as B; to handle A as if it were B (Usually written using kana alone) (as AをBにする)|14. to feel A about B (Usually written using kana alone) (as AをBにする)||Suffix, Suru verb - irregular:|15. verbalizing suffix (applies to nouns noted in this dictionary with the part of speech "vs") (Usually written using kana alone)||Auxiliary verb, Suru verb - irregular:|16. creates a humble verb (after a noun prefixed with "o" or "go") (Usually written using kana alone)|17. to be just about to; to be just starting to; to try to; to attempt to (Usually written using kana alone) (as 〜うとする,〜ようとする)
あれ	Noun:|1. that (indicating something distant from both speaker and listener (in space, time or psychologically), or something understood without naming it directly) (Usually written using kana alone)|2. that person (used to refer to one's equals or inferiors)|3. over there (Archaism)|4. down there (i.e. one's genitals) (Colloquialism)|5. period; menses (Colloquialism)|6. hey (expression of surprise, suspicion, etc.); huh?; eh? (Usually written using kana alone)||Noun:|7. that (something mentioned before which is distant psychologically or in terms of time) (Usually written using kana alone)
バス	Noun:|1. bus|2. bath|3. bass
一日	ついたち	Noun:|1. first day of the month (usu. 一日 or １日)|2. first ten days of the lunar month (Archaism)
三日	みっか	Noun:|1. the third day of the month|2. three days
五日	いつか	Noun:|1. the fifth day of the month|2. five days
二日	ふつか	Noun:|1. second day of the month|2. two days
十日	とおか	Noun:|1. the tenth day of the month|2. ten days
六日	むいか	Noun:|1. sixth day of the month|2. six days
八日	ようか	Noun:|1. the eighth day of the month|2. eight days
九日	ここのか	Noun:|1. the ninth day of the month|2. nine days
来る	くる	Kuru verb - special class, intransitive verb:|1. to come (spatially or temporally); to approach; to arrive||Kuru verb - special class, intransitive verb, Auxiliary verb:|2. to come back; to do ... and come back|3. to come to be; to become; to get; to grow; to continue||Kuru verb - special class, intransitive verb:|4. to come from; to be caused by; to derive from|5. to come to (i.e. "when it comes to spinach ...")
後	あと	Noun, No-adjective:|1. behind; rear|2. after; later|3. after one's death|4. remainder; the rest|5. descendant; successor; heir||Adverbial noun:|6. more (e.g. five more minutes); left|7. also; in addition||Noun, No-adjective:|8. past; previous (Archaism)
一人	ひとり	Noun:|1. one person (esp. 一人)|2. alone; unmarried; solitary (esp. 独り)
二人	ふたり	Noun:|1. two persons; two people; pair; couple
そば	Noun:|1. near; close; beside; vicinity; proximity; besides; while (Usually written using kana alone)|2. third person
いいえ	:|1. no; nay (Usually written using kana alone)|2. well; er; why (Usually written using kana alone)|3. you're welcome; not at all; don't mention it (Usually written using kana alone)
地図	ちず	Noun:|1. map||Wikipedia definition:|2. Map
辛い	からい	I-adjective:|1. spicy; hot|2. salty|3. harsh (criticism); severe (punishment); strict|4. painful; bitter; difficult; tough
門	もん	Noun, Noun - used as a suffix:|1. gate|2. branch of learning based on the teachings of a single master|3. division; phylum (Biology term)||Counter:|4. counter for cannons
角	かど	Noun:|1. corner (e.g. desk, pavement)|2. edge
毎月	まいつき	Adverbial noun, Noun:|1. every month; each month; monthly
七	しち	Numeric:|1. seven (漆 is used in legal documents)||Prefix:|2. hepta-
おばさん	Noun:|1. aunt (Honorific or respectful (sonkeigo), Familiar language, Usually written using kana alone) (伯母さん is older than one's parent and 叔母さん is younger)
お風呂	おふろ	Noun:|1. bath
四	し	Numeric:|1. four (肆 is used in legal documents)
お酒	おさけ	Noun:|1. alcohol; sake (Polite (teineigo))
入口	いりぐち	Noun, No-adjective:|1. entrance; entry; gate; approach; mouth
出口	でぐち	Noun:|1. exit; gateway; way out; outlet; leak; vent
お皿	おさら	Noun:|1. plate; dish
昼ご飯	ひるごはん	Noun:|1. lunch; midday meal
鳥肉	とりにく	Noun:|1. chicken meat; bird meat
これ	Pronoun:|1. this (indicating an item near the speaker, the action of the speaker, or the current topic) (Usually written using kana alone)|2. this person (usu. indicating someone in one's in-group) (Humble (kenjougo))|3. now|4. here (Archaism)|5. I (me) (Archaism)|6. certainly (Archaism)
ここ	Pronoun:|1. here (place physically close to the speaker, place pointed by the speaker while explaining); this place (Usually written using kana alone)|2. these last (followed by a duration noun and a past sentence: time period before the present time of the speaker) (Usually written using kana alone)|3. these next ... (followed by a duration noun and a non past sentence: time period after the present time of the speaker); the next ... (Usually written using kana alone)
前	まえ	Adverbial noun, Temporal noun, Suffix:|1. ago; before (some event); previously; (minutes) to (the hour)|2. in front (of); before (e.g. the house)|3. head (of a line); front (e.g. of a bus); fore part|4. in the presence of|5. helping; portion|6. privates; private parts
もう	Adverb:|1. now; soon; shortly; before long; presently|2. already; yet; by now; (not) anymore|3. further; more; again; another; the other|4. tsk; dammit; jeez; come on (used to strengthen expression of an emotion (often exasperation))
どう	Adverb:|1. how; in what way; how about (Usually written using kana alone)
方	かた	Noun:|1. direction; way (also ほう)|2. person; lady; gentleman (Honorific or respectful (sonkeigo))||Noun, Noun - used as a suffix:|3. method of; manner of; way of||Noun - used as a suffix:|4. care of ...|5. person in charge of ... (also がた)|6. side (e.g. "on my mother's side") (also がた)
まだ	Adverb:|1. as yet; hitherto; only; still (Usually written using kana alone)|2. not yet (Usually written using kana alone) (with verb in the negative)|3. more; besides (Usually written using kana alone)||Na-adjective:|4. unfinished; incomplete; not yet finished with (Usually written using kana alone)
もっと	Adverb:|1. (some) more; even more; longer; further
いつ	Adverbial noun:|1. when; how soon (Usually written using kana alone)
パーティ	Noun:|1. party
他	ほか	Noun, No-adjective:|1. other (place, thing, person); the rest|2. outside; beyond (Usually written using kana alone) (esp. 外)||Adverbial noun:|3. nothing except; nothing but; nothing apart from; nothing aside from; no choice (but to) (Usually written using kana alone) (as 〜ほか〜ない, usu. after より or the dictionary form of a verb)|4. besides...; in addition to... (often as ほかに)
次	つぎ	Noun, No-adjective:|1. next; following; subsequent|2. stage; station
ドア	Noun:|1. door (Western-style)
どちら	Pronoun:|1. which way; which direction; where (Usually written using kana alone) (どちら is polite)|2. which one (esp. of two alternatives)|3. who
誰か	だれか	Pronoun:|1. someone; somebody
開く	あく	Godan verb with ku ending, intransitive verb:|1. to open (e.g. doors) (esp. 開く)|2. to open (e.g. business, etc.) (esp. 開く)|3. to be empty (esp. 空く)|4. to be vacant; to be available; to be free (esp. 空く)|5. to be open (e.g. neckline, etc.) (esp. 明く)|6. to have been opened (of one's eyes, mouth, etc.) (esp. 明く)|7. to come to an end (esp. 明く)||Godan verb with ku ending, Transitive verb:|8. to open (one's eyes, mouth, etc.) (esp. 明く)||Godan verb with ku ending, intransitive verb:|9. to have a hole; to form a gap; to have an interval (between events)
どうぞ	Adverb:|1. please; kindly; I beg of you|2. by all means; feel free; you are welcome|3. here you are (previously written as 何卒)
こんな	Pre-noun adjectival:|1. such (about something or someone close to the speaker (including the speaker), or about ideas expressed by the speaker); like this
下	した	Noun:|1. below; down; under; younger (e.g. daughter)|2. bottom|3. beneath; underneath|4. just after; right after (as 下から, 下より, etc.)||Noun, No-adjective:|5. inferiority; one's inferior (i.e. one's junior)||Noun:|6. trade-in||Noun - used as a prefix:|7. preliminary; preparatory
そして	Conjunction:|1. and; and then; thus; and now; and finally (Usually written using kana alone)
ゆっくり	Adverb, Noun, Suru verb, Adverb taking the 'to' particle:|1. slowly; at ease; restful (Onomatopoeic or mimetic word)
コート	Noun:|1. coat|2. court (i.e. tennis, basketball, etc.)
さあ	Conjunction:|1. come; come now; come along; go on; hurry up|2. well; who knows; I don't know...; uh; hmm|3. well now; let's see; there we go; all right (said when surprised or happy)|4. about that; you see
どうも	:|1. thank you; thanks (Abbreviation)||Adverb:|2. much (thanks); very (sorry); quite (regret)|3. quite; really; mostly|4. somehow|5. in spite of oneself; try as one might; no matter how hard one may try (to, not to)|6. greetings; hello; goodbye
じゃあ	Conjunction:|1. then; well; so; well then|2. combination of 'de' and 'wa' particles||Auxiliary:|3. plain copula (Kansai dialect)
コップ	Noun:|1. glass (drinking vessel); tumbler (also written 洋盃 and 骨杯)|2. cop (police officer) (Slang)
それから	Expression:|1. and then; after that (Usually written using kana alone)
ええ	:|1. yes; that is correct; right|2. um; errr|3. huh?|4. grrr; gah; Must I?||Noun or verb acting prenominally:|5. good (Kansai dialect)
ノート	Noun:|1. notebook; copy-book; exercise book (Abbreviation)||Noun, Suru verb:|2. note; noting down||Noun:|3. (musical) note|4. notebook computer; laptop (Abbreviation)
ボタン	Noun:|1. button (Usually written using kana alone) (kanji is only used for push-buttons)
デパート	Noun:|1. department store (Abbreviation)|2. department (Abbreviation)
トイレ	Noun:|1. toilet; restroom; bathroom; lavatory (Abbreviation)
それでは	Expression:|1. well then ... (Usually written using kana alone)|2. in that situation; in which case (Usually written using kana alone)
フォーク	Noun:|1. fork|2. folk; folk song|3. hawk
明後日	あさって	Adverbial noun, Temporal noun:|1. day after tomorrow
どれ	Pronoun:|1. which (of three or more) (Usually written using kana alone)|2. whichever; any (with a verb in 〜ても form)|3. well; now; let me see
二十歳	はたち	Noun:|1. 20 years old|2. twenty (Archaism)
あちら	Pronoun:|1. that way (direction distant from both speaker and listener); over there; yonder (Usually written using kana alone)|2. that one (something physically distant from both speaker and listener, or something not visible but known by both speaker and listener); that|3. that person (someone physically distant from both speaker and listener, or someone not present but known by both speaker and listener) (あちら is pol.)|4. there (place distant from both speaker and listener); over there; foreign country (esp. a Western nation)
では	Conjunction:|1. then; well; so; well then
フィルム	Noun:|1. film
ぬるい	I-adjective:|1. lukewarm; tepid (Usually written using kana alone) (ぬくい is primarily used in Western Japan)|2. lenient (Usually written using kana alone)|3. slow; stupid (Usually written using kana alone, Archaism)
四日	よっか	Noun:|1. fourth day of the month|2. four days
カレンダー	Noun:|1. calendar|2. calender (machine for flattening things)
七日	なのか	Adverbial noun:|1. the seventh day of the month|2. seven days
そうして	Conjunction:|1. and; like that (Usually written using kana alone)
グラム	Noun:|1. gram; gramme (Usually written using kana alone)
キログラム	Noun:|1. kilogram; kilogramme (Usually written using kana alone)
すぐに	Adverb:|1. immediately; right away; at once; instantly (Usually written using kana alone)
一月	ひとつき	Noun:|1. one month
あのう	:|1. say; well; errr ...
マッチ	Noun:|1. match (contest)||Suru verb:|2. to match with; to go well with||Wikipedia definition:|3. Match
秋	あき	Temporal noun:|1. autumn; fall
マッチ	Noun:|1. match (to light fire with) (Usually written using kana alone)
字引	じびき	Noun:|1. dictionary
カレー	Noun:|1. curry (Usually written using kana alone)|2. rice and curry (Abbreviation, Usually written using kana alone)
三	サン	Numeric:|1. three
ラジカセ	Noun:|1. radio-cassette player (Abbreviation)
ＰＥＴ	ペット	Noun:|1. polyethylene terephthalate; PET|2. positron emission tomography; PET